Aalifa: ramah dan bersahabat
Adeeva: nyaman dan menyenangkan
Aghnia: kaya
Alesha: beruntung, selalu dilindungi Allah
Azalia: yang dilindungi Allah
Aziza: berharga dan mulia
Alina: sutra dari surga
Alishba: cantik
Aiza: perkasa, dihormati, serta mulia
Aisyah: istri Nabi Muhammad SAW
Bushra: kabar gembira
Bahira: pintar
Baqiya: selamanya
Balqis: ratu Negeri Saba
Chana: kesayangan
Chayra: kebaikan
Ciara: bersih, terang
Cyra: bulan
Chafia: penuh perhatian
Daneen: putri
Dalilah: petunjuk jalan
Dzakiya: cerdas
Dairah: lemah lembut
Dania: dekat
Dianna: surga
Durriya: bersinar terang
Elham: memberikan inspirasi
Eiman: iman
Enisa: teman baik
Eiliyah: bertumbuh dalam damai dan cinta Allah
Eshal: nama bunga di surga
Erina: cantik
Farah: senang
Fairuz: permata
Fatimah: nama putri Nabi Muhammad SAW
Fauziyah: beruntung
Fathinah: cerdas
Falihah: kesuksesan
Fildzhah: belahan hati
Faizah: menang
Fakhirah: kebanggaan orangtua
Fazluna: bunga di padang pasir
Ghaniyah: harta berlimpah
Ghina: kekayaan
Gamila: indah
Ghazalah: matahari terbit
Hafidzah: penghafal
Hilya: perhiasan
Hafa: hujan yang lembut
Hanifah: muslimah yang teguh
Inayah: perlindungan, perhatian, penuh kasih sayang
Izzati: kemuliaan
Iaesha: anak perempuan lincah
Jameela: cantik
Jannah: masuk dalam daftar rangkaian nama bayi perempuan islami yang cantik, artinya surga
Jasmin: bunga melati
Janeeta: hadiah Allah
Khadijah: istri Muhammad SAW
Kamilah: sempurna
Khalisa: suci, bersih dan murni
Khansa: wanita yang baik
Kamaria: bulan
Laila: kegembiraan hingga malam gelap
Layyanah: halus dan lembut
Laila: malam hari
Lahya: hadiah
Maryam: Masuk dalam daftar nama bayi perempuan menurut islam dan alquran yang artinya perempuan yang dimuliakan Allah
Mafaza : kesuksesan besar
Mahabbah: cinta dan kasih sayang
Mazaya: unggul diantara yang lain
Nada: embun
Namiah: sempurna
Naadhira: berbahagia, berseri-seri
Nuha: kecerdasaan
Oamra: bulan
Ouarda: bunga mawar
Paransa: sutra
Pakiza: murni
Qasrina: istana
Qistina: adil
Qadriya: percaya kehendak Allah
Rahilah: lembut lembut
Rani : perempuan sukses
Ruhama : pemberi kasih sayang
Syarafana: kemuliaan
Syahmina: cerdik
Taslima: salam
Tihani: bahagia
Tahira: suci dan bersih
Uaine: bangsawan
Uthailah: mulia
Ualana: hujan
Vahira: bunga melur
Varisha: petir
Wasima: cantik dan anggun
Wadha: cemerlang
Xavia: terang
Yumna: sukses dan keberuntungan
Zaakiyah: baik
Zahrah: bunga

Aisha Khalisa: Anak yang murni dan suci.
Aisha Qanita: Anak yang taat kepada Allah.
Amina Hafizah: Anak yang menjaga dan melindungi.
Amina Salwa: Anak yang membawa kenyamanan.
Amina Shafia: Anak yang membawa kebaikan dan kebijaksanaan.
Amira Khairina: Anak yang baik dan beruntung.
Amani Khairina: Anak yang membawa keberuntungan.
Ayra Safiyya: Anak yang suci dan murni.
Dina Aqila: Anak yang cerdas dan bijaksana.
Dina Yasirah: Anak yang bersyukur.
Farah Amani: Anak yang membawa kedamaian.
Hana Azzahra: Anak yang bersinar terang.
Hana Dhiya: Anak yang memiliki cahaya dalam hidupnya.
Haniyah Zaynab: Anak yang mulia dan bercahaya.
Khadijah Shafia: Anak yang jujur dan baik.
Layla Insyirah: Anak yang membawa kebahagiaan.
Layla Nadhira: Anak yang istimewa dan berharga.
Laila Amalia: Anak yang memiliki amal yang baik.
Laila Zulfa: Anak yang berwibawa dan anggun.
Marwa Imani: Anak yang memiliki iman.
Marwa Safira: Anak yang bercahaya dan bersinar.
Nada Izzah: Anak yang memiliki kehormatan.
Nada Zahirah: Anak yang jelas dan berseri.
Rania Zakiyah: Anak yang berkah dan bijaksana.
Rifa Amalia: Anak yang beramal dengan baik.
Rifa Haniyah: Anak yang bahagia dan bercahaya.
Safiya Aqila: Anak yang bijaksana dan cerdas.
Sara Imanina: Anak yang memiliki iman yang kuat.
Sarah Khalilah: Anak yang menjadi teman sejati.
Siti Amina: Anak yang aman dan terlindungi.
Siti Hanan: Anak yang penuh kasih sayang.
Siti Khansa: Anak yang penuh semangat.
Yasira Dhaniyah: Anak yang penuh keberanian.
Yasmin Aulia: Anak yang agung dan mulia.
Yasmin Raihana: Anak yang harum dan indah.
Yasmin Salwa: Anak yang membawa kedamaian.
Zahra Husna: Anak yang cantik dan mulia.
Zahra Khalisa: Anak yang murni dan suci.
Zara Fathiyah: Anak yang memiliki kelebihan.
Zara Hafizah: Anak yang menjaga dan melindungi.
Zaina Aulia: Anak yang agung dan hebat.
Zara Nadira: Anak yang istimewa dan berseri.
Zara Khairina: Anak yang baik dan beruntung.
Zara Yasmina: Anak yang hidup dalam kedamaian.
Zainab Qaisara: Anak yang mulia dan agung.

Adeeva Bareeka Caria: lembut dan dicintai banyak orang seperti bunga merekah
Ahad Damira Fayroz: selalu penuhi janji dan panjang umur di dunia
Anisha Eila Haadiya: teman yang baik, ramah dan hadiah dari Allah
Amaal Benazir Farida: pemimpin yang memberikan harapan dan paling berharga
Ayesha Farah Inaya: inspirasi dari istri Nabi yang selalu gembira dan peduli sesama
Aiza Iqra Samreen: seseorang yang dihormati dan melakukan hal bermanfaat
Bilkis Ayesha Cancandanc: cahaya inspirasi dari ratu Sheba dan istri dari Nabi
Baashima Dalila Jasmine: selalu tersenyum dan lembut seperti bunga jasmine
Bushra Kiran Rimsha: membawa kabar gembira seperti cahaya dan secantik bunga
Chellam Imaan Jannat: memberikan perhatian dalam iman dan merepresentasikan surga
Daaria Inbihaaj Mahaa: selalu pada jalan benar, murni dan bergembira
Dania Jahanara Khatija: Kuat, adil dan bisa dipercaya
Dana Jude Marwa: secantik mutiara, murah hati dan selembut batu putih
Eira Feroza Laakia: salju yang lembut dan berharga lebih daripada harta karun
Elijah Aishah Fatima: cantik, cerdas dan hidup sejahtera seperti anak perempuan Nabi
Fara Sarah Maaysa: selalu bergembira dan percaya diri seperti seorang putri kerajaan
Huda Reema Naayla: kemenangan berpegang teguh pada jalan benar dari nama putri Mesir
Ibtisam Aya Latifa: selalu tersenyum, keajaiban dan lembut
Jaleela Raaya Mehar: berbuat masyhur dan baik hati menjadi teman hidup
Khadija Fauzia Anam: inspirasi dari istri Nabi yang berjaya dan ciptaan Allah
Kaarima Taleeha Malala: dermawan penuh pengetahuan dan tidak pernah mengeluh
Laiba Rida Kinza: seorang malaikat surga berharga yang difavoritkan Allah
Mallika Sofia Naazwa: pintar, bijak, baik hati dan selalu penuh semangat
Nausheen Salima Leena: sikapnya lembut, hangat, manis dan tanpa cela setiap jalannya
Oma Nour Layla: berkembang seperti cahaya malam
Pegah Qadira Shakufa: selalu mampu lewati fajar baru seperti bunga yang mekar indah
Qistina Safiyah Yasmin: adil dan murni seperti bunga jasmine
Reeda Shakira Ziah: bersyukur, setia pada Allah dan selalu bersinar di tengah kegelapan
Shazia Maira Amara: seorang putri yang cerah dan melambangkan kecantikan
Tabana Qamara Veeya: nama bayi perempuan islami 3 kata 2021 beserta artinya cerah seperti bulan dan kaya
Urwa Sidra Farheen: anak perempuan yang selalu mendukung dan membawa kebahagiaan
Vida Yara Siddiqa: cantik, lembut, memiliki kualitas arah hidup dan berpegang teguh pada ucapan
Wajiha Hiba Mariam: inspirasi nama ibu Nabi yang terkemuka dan hadiah dari Allah
Yameena Afaf Zara: sederhana, suci dan dibesarkan dengan cara tepat seperti bunga yang alami
Zahra Fazluna Yasmeen: nama populer islami yang artinya gurun dan bunga jasmine di padang pasir




<ol>
    <li data-list="ordered"><span class="ql-ui" contenteditable="false"></span>Aanaya yang memiliki arti diberkati Tuhan</li>
    <li data-list="ordered"><span class="ql-ui" contenteditable="false"></span>Adrishta yang memiliki arti selalu beruntung</li>
    <li data-list="ordered"><span class="ql-ui" contenteditable="false"></span>Aishwarya yang memiliki arti kaya dan makmur</li>
    <li data-list="ordered"><span class="ql-ui" contenteditable="false"></span>Ardhiona yang memiliki arti memiliki jiwa yang teguh</li>
    <li data-list="ordered"><span class="ql-ui" contenteditable="false"></span>Aristawidya yang memiliki arti lemah lembut</li>
    <li data-list="ordered"><span class="ql-ui" contenteditable="false"></span>Apsarini yang memiliki arti cantik dan bidadari</li>
    <li data-list="ordered"><span class="ql-ui" contenteditable="false"></span>Arunya yang memiliki arti sinar matahari pertama</li>
    <li data-list="ordered"><span class="ql-ui" contenteditable="false"></span>Atulya yang memiliki arti tak tertandingi</li>
    <li data-list="ordered"><span class="ql-ui" contenteditable="false"></span>Awandini yang memiliki arti baik, mulia</li>
    <li data-list="ordered"><span class="ql-ui" contenteditable="false"></span>Banurasmi yang memiliki arti surya</li>
    <li data-list="ordered"><span class="ql-ui" contenteditable="false"></span>Balika yang memiliki arti anak perempuan</li>
    <li data-list="ordered"><span class="ql-ui" contenteditable="false"></span>Bharani yang memiliki arti permata</li>
    <li data-list="ordered"><span class="ql-ui" contenteditable="false"></span>Bavika yang memiliki arti penuh dengan perasaan/emosi</li>
    <li data-list="ordered"><span class="ql-ui" contenteditable="false"></span>Bhama yang memiliki arti penuh dengan cahaya</li>
    <li data-list="ordered"><span class="ql-ui" contenteditable="false"></span>Charushela yang memiliki arti kepribadian yang indah</li>
    <li data-list="ordered"><span class="ql-ui" contenteditable="false"></span>Chayanika yang memiliki arti yang terpilih</li>
    <li data-list="ordered"><span class="ql-ui" contenteditable="false"></span>Chandani yang memiliki arti batu pualam</li>
    <li data-list="ordered"><span class="ql-ui" contenteditable="false"></span>Charvi yang memiliki arti perempuan cantik</li>
    <li data-list="ordered"><span class="ql-ui" contenteditable="false"></span>Chitra yang memiliki arti suatu seni</li>
    <li data-list="ordered"><span class="ql-ui" contenteditable="false"></span>Chitragandha yang memiliki arti Dewi Sarasvati</li>
    <li data-list="ordered"><span class="ql-ui" contenteditable="false"></span>Chetana yang memiliki arti penuh semangat</li>
    <li data-list="ordered"><span class="ql-ui" contenteditable="false"></span>Devara yang memiliki arti kekasih</li>
    <li data-list="ordered"><span class="ql-ui" contenteditable="false"></span>Dharsana yang memiliki arti melihat</li>
    <li data-list="ordered"><span class="ql-ui" contenteditable="false"></span>Dameetha yang memiliki arti berperilaku baik</li>
    <li data-list="ordered"><span class="ql-ui" contenteditable="false"></span>Dian yang memiliki arti cahaya</li>
    <li data-list="ordered"><span class="ql-ui" contenteditable="false"></span>Diva yang memiliki arti cahaya yang kekal</li>
    <li data-list="ordered"><span class="ql-ui" contenteditable="false"></span>Erisha yang memiliki arti bahasa</li>
    <li data-list="ordered"><span class="ql-ui" contenteditable="false"></span>Eesha yang memiliki arti kemurnian</li>
    <li data-list="ordered"><span class="ql-ui" contenteditable="false"></span>Enzi yang memiliki arti kekuasaan tertinggi</li>
    <li data-list="ordered"><span class="ql-ui" contenteditable="false"></span>Ekani yang memiliki arti satu</li>
    <li data-list="ordered"><span class="ql-ui" contenteditable="false"></span>Gandali yang memiliki arti aroma manis</li>
    <li data-list="ordered"><span class="ql-ui" contenteditable="false"></span>Gagana yang memiliki arti langit</li>
    <li data-list="ordered"><span class="ql-ui" contenteditable="false"></span>Ganesa yang memiliki arti semoga sukses</li>
    <li data-list="ordered"><span class="ql-ui" contenteditable="false"></span>Ganika yang memiliki arti bunga</li>
    <li data-list="ordered"><span class="ql-ui" contenteditable="false"></span>Gatita yang memiliki arti sungai</li>
    <li data-list="ordered"><span class="ql-ui" contenteditable="false"></span>Garima yang memiliki arti kehangatan, kekuatan</li>
    <li data-list="ordered"><span class="ql-ui" contenteditable="false"></span>Gaura yang memiliki arti seorang wanita adil, Dewi Parwati</li>
    <li data-list="ordered"><span class="ql-ui" contenteditable="false"></span>Gavya yang memiliki arti taman dewa</li>
    <li data-list="ordered"><span class="ql-ui" contenteditable="false"></span>Hasmita yang memiliki arti selalu bahagia</li>
    <li data-list="ordered"><span class="ql-ui" contenteditable="false"></span>Harsha yang memiliki arti kesenangan</li>
    <li data-list="ordered"><span class="ql-ui" contenteditable="false"></span>Istari yang memiliki arti bercita-cita tinggi</li>
    <li data-list="ordered"><span class="ql-ui" contenteditable="false"></span>Iswari yang memiliki arti akan menjadi orang yang terhormat</li>
    <li data-list="ordered"><span class="ql-ui" contenteditable="false"></span>Isyana yang memiliki arti makmur</li>
    <li data-list="ordered"><span class="ql-ui" contenteditable="false"></span>Iyla yang memiliki arti cahaya bulan</li>
    <li data-list="ordered"><span class="ql-ui" contenteditable="false"></span>Isvara yang memiliki arti pemimpin yang berkuasa</li>
    <li data-list="ordered"><span class="ql-ui" contenteditable="false"></span>Jasarani yang yang memiliki arti ratu yang terkenal</li>
    <li data-list="ordered"><span class="ql-ui" contenteditable="false"></span>Jevanta yang yang memiliki arti pencipta</li>
    <li data-list="ordered"><span class="ql-ui" contenteditable="false"></span>Juwita yang memiliki arti cinta</li>
    <li data-list="ordered"><span class="ql-ui" contenteditable="false"></span>Janavee yang yang memiliki arti cantik, imut</li>
    <li data-list="ordered"><span class="ql-ui" contenteditable="false"></span>Jineesha yang yang memiliki arti gadis cantik</li>
    <li data-list="ordered"><span class="ql-ui" contenteditable="false"></span>Jitha yang memiliki arti setelah menaklukkan</li>
    <li data-list="ordered"><span class="ql-ui" contenteditable="false"></span>Jeevaa yang memiliki arti kehidupan abadi</li>
    <li data-list="ordered"><span class="ql-ui" contenteditable="false"></span>Josya yang memiliki arti menyenangkan</li>
    <li data-list="ordered"><span class="ql-ui" contenteditable="false"></span>Jaamini yang memiliki arti bunga malam</li>
    <li data-list="ordered"><span class="ql-ui" contenteditable="false"></span>Jaina yang memiliki arti memiliki karakter yang baik</li>
    <li data-list="ordered"><span class="ql-ui" contenteditable="false"></span>Jailshila yang memiliki arti dewi kemenangan</li>
    <li data-list="ordered"><span class="ql-ui" contenteditable="false"></span>Keertana yang memiliki arti lagu renungan</li>
    <li data-list="ordered"><span class="ql-ui" contenteditable="false"></span>Kana yang memiliki arti kekuatan</li>
    <li data-list="ordered"><span class="ql-ui" contenteditable="false"></span>Kavita yang memiliki arti puisi</li>
    <li data-list="ordered"><span class="ql-ui" contenteditable="false"></span>Lakshya yang memiliki arti tujuan</li>
    <li data-list="ordered"><span class="ql-ui" contenteditable="false"></span>Larasati yang memiliki arti yang berjiwa tenang</li>
    <li data-list="ordered"><span class="ql-ui" contenteditable="false"></span>Lasmaya yang memiliki arti berakhir dengan semu</li>
    <li data-list="ordered"><span class="ql-ui" contenteditable="false"></span>Kaulika yang memiliki arti yang dilahirkan di tengah-tengah kaum ningrat</li>
    <li data-list="ordered"><span class="ql-ui" contenteditable="false"></span>Leela yang memiliki arti utusan ilahi</li>
    <li data-list="ordered"><span class="ql-ui" contenteditable="false"></span>Maharani yang memiliki arti permaisuri</li>
    <li data-list="ordered"><span class="ql-ui" contenteditable="false"></span>Maliqa yang memiliki arti bunga</li>
    <li data-list="ordered"><span class="ql-ui" contenteditable="false"></span>Naina yang memiliki arti mata</li>
    <li data-list="ordered"><span class="ql-ui" contenteditable="false"></span>Nandadevi yang memiliki arti dewi kebahagiaan</li>
    <li data-list="ordered"><span class="ql-ui" contenteditable="false"></span>Nadindra yang memiliki arti sungai yang besar dan dalam</li>
    <li data-list="ordered"><span class="ql-ui" contenteditable="false"></span>Nareswari yang memiliki arti pendiam dan jujur</li>
    <li data-list="ordered"><span class="ql-ui" contenteditable="false"></span>Nala yang memiliki arti jantung hati</li>
    <li data-list="ordered"><span class="ql-ui" contenteditable="false"></span>Nanda yang memiliki arti kebahagiaan</li>
    <li data-list="ordered"><span class="ql-ui" contenteditable="false"></span>Nara yang memiliki arti manusia</li>
    <li data-list="ordered"><span class="ql-ui" contenteditable="false"></span>Nararya yang memiliki arti yang dimuliakan</li>
    <li data-list="ordered"><span class="ql-ui" contenteditable="false"></span>Narasnama yang memiliki arti nama yang suci</li>
    <li data-list="ordered"><span class="ql-ui" contenteditable="false"></span>Pramidita yang memiliki arti pandai</li>
    <li data-list="ordered"><span class="ql-ui" contenteditable="false"></span>Pratista yang memiliki arti berdiri dengan tegap</li>
    <li data-list="ordered"><span class="ql-ui" contenteditable="false"></span>Putri yang memiliki arti anak perempuan</li>
    <li data-list="ordered"><span class="ql-ui" contenteditable="false"></span>Pavithra yang memiliki arti suci, murni, dan lembut</li>
    <li data-list="ordered"><span class="ql-ui" contenteditable="false"></span>Prita yang memiliki arti yang terkasih</li>
    <li data-list="ordered"><span class="ql-ui" contenteditable="false"></span>Priya yang memiliki arti dikasihi, penuh cinta</li>
    <li data-list="ordered"><span class="ql-ui" contenteditable="false"></span>Priyanka yang memiliki arti kesukaan semua orang</li>
    <li data-list="ordered"><span class="ql-ui" contenteditable="false"></span>Rananta yang memiliki arti merantai</li>
    <li data-list="ordered"><span class="ql-ui" contenteditable="false"></span>Raheela yang memiliki arti melakukan perjalanan</li>
    <li data-list="ordered"><span class="ql-ui" contenteditable="false"></span>Ranjana yang memiliki arti menghibur, menyenangkan</li>
    <li data-list="ordered"><span class="ql-ui" contenteditable="false"></span>Rachana yang memiliki arti ciptaan</li>
    <li data-list="ordered"><span class="ql-ui" contenteditable="false"></span>Rashmi yang memiliki arti cahaya bulan, sinar matahari, bersinar, sinar cahaya yang bersinar, bercahaya</li>
    <li data-list="ordered"><span class="ql-ui" contenteditable="false"></span>Saraswati yang memiliki arti pembawa kesembuhan</li>
    <li data-list="ordered"><span class="ql-ui" contenteditable="false"></span>Swara yang memiliki arti nama lain Dewi Saraswati</li>
    <li data-list="ordered"><span class="ql-ui" contenteditable="false"></span>Savrinadeya yang memiliki arti selalu membela kebajikan</li>
    <li data-list="ordered"><span class="ql-ui" contenteditable="false"></span>Tamanna yang memiliki arti harapan</li>
    <li data-list="ordered"><span class="ql-ui" contenteditable="false"></span>Tamasvini yang memiliki arti malam</li>
    <li data-list="ordered"><span class="ql-ui" contenteditable="false"></span>Vandana yang memiliki arti doa atau permohonan</li>
    <li data-list="ordered"><span class="ql-ui" contenteditable="false"></span>Varenya yang memiliki arti yang terbaik</li>
    <li data-list="ordered"><span class="ql-ui" contenteditable="false"></span>Varnika yang memiliki arti kemurnian emas</li>
    <li data-list="ordered"><span class="ql-ui" contenteditable="false"></span>Venya yang memiliki arti menyenangkan</li>
    <li data-list="ordered"><span class="ql-ui" contenteditable="false"></span>Vineeta yang memiliki arti rendah hati, sederhana</li>
    <li data-list="ordered"><span class="ql-ui" contenteditable="false"></span>Yashasvi yang memiliki arti terkenal</li>
    <li data-list="ordered"><span class="ql-ui" contenteditable="false"></span>Yachita yang memiliki arti memohon kekuatan</li>
    <li data-list="ordered"><span class="ql-ui" contenteditable="false"></span>Zhyani yang memiliki arti ramah</li>
</ol>
<ol>
    <li data-list="ordered"><span class="ql-ui" contenteditable="false"></span>Acha yang memiliki arti baik hati dan cerdas</li>
    <li data-list="ordered"><span class="ql-ui" contenteditable="false"></span>Aine yang memiliki arti bercahaya, cerdas</li>
    <li data-list="ordered"><span class="ql-ui" contenteditable="false"></span>Akilah yang memiliki arti cerdas, berintelektual tinggi</li>
    <li data-list="ordered"><span class="ql-ui" contenteditable="false"></span>Akira yang memiliki arti cerdas, bersinar, intelektual</li>
    <li data-list="ordered"><span class="ql-ui" contenteditable="false"></span>Anggun yang memiliki arti luwes dan bermartabat</li>
    <li data-list="ordered"><span class="ql-ui" contenteditable="false"></span>Anatari yang memiliki arti pemimpin yang jeli</li>
    <li data-list="ordered"><span class="ql-ui" contenteditable="false"></span>Anjani yang memiliki arti ketekunan</li>
    <li data-list="ordered"><span class="ql-ui" contenteditable="false"></span>Balinda yang memiliki arti bijaksana</li>
    <li data-list="ordered"><span class="ql-ui" contenteditable="false"></span>Darra yang memiliki arti cemerlang</li>
    <li data-list="ordered"><span class="ql-ui" contenteditable="false"></span>Dzakiyyah yang memiliki arti cerdas</li>
    <li data-list="ordered"><span class="ql-ui" contenteditable="false"></span>Dzikra yang memiliki arti ingatan, ketenangan, zikir</li>
    <li data-list="ordered"><span class="ql-ui" contenteditable="false"></span>Elina yang memiliki arti perempuan yang pandai</li>
    <li data-list="ordered"><span class="ql-ui" contenteditable="false"></span>Erianna yang memiliki arti wanita yang bijaksana</li>
    <li data-list="ordered"><span class="ql-ui" contenteditable="false"></span>Eriyanna yang memiliki arti teman yang bijaksana dan mulia</li>
    <li data-list="ordered"><span class="ql-ui" contenteditable="false"></span>Elenora yang memiliki arti bijaksana</li>
    <li data-list="ordered"><span class="ql-ui" contenteditable="false"></span>Ekanta memiliki makna gadis yang tekun</li>
    <li data-list="ordered"><span class="ql-ui" contenteditable="false"></span>Farzana yang memiliki arti kecerdasan</li>
    <li data-list="ordered"><span class="ql-ui" contenteditable="false"></span>Faizza yang memiliki arti cerdas</li>
    <li data-list="ordered"><span class="ql-ui" contenteditable="false"></span>Farzanna yang memiliki arti cerdas</li>
    <li data-list="ordered"><span class="ql-ui" contenteditable="false"></span>Farzin yang memiliki arti cerdas</li>
    <li data-list="ordered"><span class="ql-ui" contenteditable="false"></span>Fateenah yang memiliki arti cerdas</li>
    <li data-list="ordered"><span class="ql-ui" contenteditable="false"></span>Fikriyyah yang memiliki arti bijaksana, cerdas</li>
    <li data-list="ordered"><span class="ql-ui" contenteditable="false"></span>Gargi yang memiliki arti nama seorang wanita terpelajar</li>
    <li data-list="ordered"><span class="ql-ui" contenteditable="false"></span>Gadis yang memiliki arti anak perempuan yang beranjak dewasa</li>
    <li data-list="ordered"><span class="ql-ui" contenteditable="false"></span>Ginanita yang memiliki arti menghitung</li>
    <li data-list="ordered"><span class="ql-ui" contenteditable="false"></span>Ganeeta yang memiliki arti penyuka angka</li>
    <li data-list="ordered"><span class="ql-ui" contenteditable="false"></span>Harper yang memiliki arti cerdas dan penuh semangat</li>
    <li data-list="ordered"><span class="ql-ui" contenteditable="false"></span>Indira yang memiliki arti anak yang membawa kejayaan dan kekayaan bagi keluarga</li>
    <li data-list="ordered"><span class="ql-ui" contenteditable="false"></span>Ismene yang memiliki arti orang yang berpengetahuan</li>
    <li data-list="ordered"><span class="ql-ui" contenteditable="false"></span>Ilina yang memiliki arti ratu, memiliki kecerdasan tinggi</li>
    <li data-list="ordered"><span class="ql-ui" contenteditable="false"></span>Jada yang memiliki arti orang yang bijaksana</li>
    <li data-list="ordered"><span class="ql-ui" contenteditable="false"></span>Jaida yang memiliki arti bijaksana dan berpengetahuan</li>
    <li data-list="ordered"><span class="ql-ui" contenteditable="false"></span>Jayla yang memiliki arti bijaksana dan penuh pengetahuan</li>
    <li data-list="ordered"><span class="ql-ui" contenteditable="false"></span>Julia yang memiliki arti bijaksana dan muda</li>
    <li data-list="ordered"><span class="ql-ui" contenteditable="false"></span>Kaelyn yang memiliki arti bijaksana dan indah</li>
    <li data-list="ordered"><span class="ql-ui" contenteditable="false"></span>Kaia yang memiliki arti anak yang bijaksana</li>
    <li data-list="ordered"><span class="ql-ui" contenteditable="false"></span>Kendra yang memiliki arti wanita yang bijaksana</li>
    <li data-list="ordered"><span class="ql-ui" contenteditable="false"></span>Khaya yang memiliki arti kebijaksanaan</li>
    <li data-list="ordered"><span class="ql-ui" contenteditable="false"></span>Kiandra yang memiliki arti putri yang bijaksana</li>
    <li data-list="ordered"><span class="ql-ui" contenteditable="false"></span>Kiara yang memiliki arti cerdas dan pintar</li>
    <li data-list="ordered"><span class="ql-ui" contenteditable="false"></span>Kyna yang memiliki arti berpengetahuan dan logis</li>
    <li data-list="ordered"><span class="ql-ui" contenteditable="false"></span>Larifa yang memiliki arti cerdas</li>
    <li data-list="ordered"><span class="ql-ui" contenteditable="false"></span>Liya yang memiliki arti cerdas</li>
    <li data-list="ordered"><span class="ql-ui" contenteditable="false"></span>Laksita yang memiliki arti anak yang cekatan</li>
    <li data-list="ordered"><span class="ql-ui" contenteditable="false"></span>Mahira yang memiliki arti cerdas</li>
    <li data-list="ordered"><span class="ql-ui" contenteditable="false"></span>Merva yang memiliki arti yang kaya akan ilmu</li>
    <li data-list="ordered"><span class="ql-ui" contenteditable="false"></span>Minda yang memiliki arti cerdas</li>
    <li data-list="ordered"><span class="ql-ui" contenteditable="false"></span>Mika yang memiliki arti cerdas</li>
    <li data-list="ordered"><span class="ql-ui" contenteditable="false"></span>Mindah yang memiliki arti cahaya pengetahuan</li>
    <li data-list="ordered"><span class="ql-ui" contenteditable="false"></span>Minda yang memiliki arti cinta dan pengetahuan</li>
    <li data-list="ordered"><span class="ql-ui" contenteditable="false"></span>Moneisha yang memiliki arti kecerdasan dan Intelektual yang hebat</li>
    <li data-list="ordered"><span class="ql-ui" contenteditable="false"></span>Maira yang memiliki arti wanita yang bijaksana</li>
    <li data-list="ordered"><span class="ql-ui" contenteditable="false"></span>Maiza yang memiliki arti bijaksana dan cerdik</li>
    <li data-list="ordered"><span class="ql-ui" contenteditable="false"></span>Maria yang memiliki arti perempuan yang bijaksana dan sabar</li>
    <li data-list="ordered"><span class="ql-ui" contenteditable="false"></span>Melissa yang memiliki arti perempuan yang bijaksana, cerdas, dan menenangkan</li>
    <li data-list="ordered"><span class="ql-ui" contenteditable="false"></span>Nabiha yang memiliki arti yang memiliki pengetahuan sebaik-baiknya</li>
    <li data-list="ordered"><span class="ql-ui" contenteditable="false"></span>Nadha yang memiliki arti pintar</li>
    <li data-list="ordered"><span class="ql-ui" contenteditable="false"></span>Najiba yang memiliki arti cerdas</li>
    <li data-list="ordered"><span class="ql-ui" contenteditable="false"></span>Nalima yang memiliki arti cerdas</li>
    <li data-list="ordered"><span class="ql-ui" contenteditable="false"></span>Narissara yang memiliki arti wanita cerdas</li>
    <li data-list="ordered"><span class="ql-ui" contenteditable="false"></span>Natiqa yang memiliki arti pintar, pandai berbicara</li>
    <li data-list="ordered"><span class="ql-ui" contenteditable="false"></span>Najyba yang memiliki arti luar biasa, cerdas</li>
    <li data-list="ordered"><span class="ql-ui" contenteditable="false"></span>Nehla yang memiliki arti bakat, cerdas,</li>
    <li data-list="ordered"><span class="ql-ui" contenteditable="false"></span>Nia yang memiliki arti cemerlang</li>
    <li data-list="ordered"><span class="ql-ui" contenteditable="false"></span>Nuriyah yang memiliki arti terang, bercahaya, cemerlang</li>
    <li data-list="ordered"><span class="ql-ui" contenteditable="false"></span>Nabiha yang memiliki arti yang memiliki pengetahuan yang sebaik-baiknya</li>
    <li data-list="ordered"><span class="ql-ui" contenteditable="false"></span>Nawang yang memiliki arti orang yang bijaksana</li>
    <li data-list="ordered"><span class="ql-ui" contenteditable="false"></span>Paramitha yang memiliki arti yang memiliki arti memiliki kesempurnaan kebijaksanaan</li>
    <li data-list="ordered"><span class="ql-ui" contenteditable="false"></span>Paramita yang memiliki arti yang memiliki arti teman baik, bijaksana</li>
    <li data-list="ordered"><span class="ql-ui" contenteditable="false"></span>Rasheda yang memiliki arti yang lurus, yang membimbing</li>
    <li data-list="ordered"><span class="ql-ui" contenteditable="false"></span>Rasyadah yang memiliki arti yang menunjuk, yang membimbing</li>
    <li data-list="ordered"><span class="ql-ui" contenteditable="false"></span>Ramona yang memiliki arti pelindung yang bijaksana</li>
    <li data-list="ordered"><span class="ql-ui" contenteditable="false"></span>Rajeena yang memiliki arti pintar</li>
    <li data-list="ordered"><span class="ql-ui" contenteditable="false"></span>Ramiza yang memiliki arti cerdas</li>
    <li data-list="ordered"><span class="ql-ui" contenteditable="false"></span>Raqima yang memiliki arti pintar</li>
    <li data-list="ordered"><span class="ql-ui" contenteditable="false"></span>Rashada yang memiliki arti pintar</li>
    <li data-list="ordered"><span class="ql-ui" contenteditable="false"></span>Rasyidah yang memiliki arti cerdas</li>
    <li data-list="ordered"><span class="ql-ui" contenteditable="false"></span>Sarina yang memiliki arti tenang dan bijaksana</li>
    <li data-list="ordered"><span class="ql-ui" contenteditable="false"></span>Shanna yang memiliki arti anak yang bijaksana</li>
    <li data-list="ordered"><span class="ql-ui" contenteditable="false"></span>Saraswati yang memiliki arti dewi ilmu pengetahuan</li>
    <li data-list="ordered"><span class="ql-ui" contenteditable="false"></span>Safiqa yang memiliki arti cerdas</li>
    <li data-list="ordered"><span class="ql-ui" contenteditable="false"></span>Saibah yang memiliki arti pintar</li>
    <li data-list="ordered"><span class="ql-ui" contenteditable="false"></span>Sehar yang memiliki arti cerdas</li>
    <li data-list="ordered"><span class="ql-ui" contenteditable="false"></span>Shadiah yang memiliki arti pintar</li>
    <li data-list="ordered"><span class="ql-ui" contenteditable="false"></span>Shaera yang memiliki arti cerdas</li>
    <li data-list="ordered"><span class="ql-ui" contenteditable="false"></span>Shayaan yang memiliki arti pintar</li>
    <li data-list="ordered"><span class="ql-ui" contenteditable="false"></span>Shazmeen yang memiliki arti pintar</li>
    <li data-list="ordered"><span class="ql-ui" contenteditable="false"></span>Shazna yang memiliki arti cerdas</li>
    <li data-list="ordered"><span class="ql-ui" contenteditable="false"></span>Sania yang memiliki arti anak perempuan cerdas</li>
    <li data-list="ordered"><span class="ql-ui" contenteditable="false"></span>Sophie yang memiliki arti yang bijaksana dan pintar</li>
    <li data-list="ordered"><span class="ql-ui" contenteditable="false"></span>Yanti yang memiliki arti nama seorang dewi</li>
    <li data-list="ordered"><span class="ql-ui" contenteditable="false"></span>Yatiwara yang memiliki arti bijak dan pandai</li>
    <li data-list="ordered"><span class="ql-ui" contenteditable="false"></span>Yatna yang memiliki arti anak yang menjadi pengingat</li>
    <li data-list="ordered"><span class="ql-ui" contenteditable="false"></span>Yetri yang memiliki arti bijak dan pandai</li>
    <li data-list="ordered"><span class="ql-ui" contenteditable="false"></span>Zahina yang memiliki arti pintar</li>
    <li data-list="ordered"><span class="ql-ui" contenteditable="false"></span>Zakia yang memiliki arti cerdas</li>
    <li data-list="ordered"><span class="ql-ui" contenteditable="false"></span>Zahira yang memiliki arti cemerlang</li>
    <li data-list="ordered"><span class="ql-ui" contenteditable="false"></span>Zakiya yang memiliki arti kecerdasan</li>
    <li data-list="ordered"><span class="ql-ui" contenteditable="false"></span>Zelmira yang memiliki arti cemerlang</li>
    <li data-list="ordered"><span class="ql-ui" contenteditable="false"></span>Zara yang memiliki arti cemerlang</li>
</ol>
<ol>
    <li data-list="ordered"><span class="ql-ui" contenteditable="false"></span>Adiratna yang memiliki arti batu pertama yang indah</li>
    <li data-list="ordered"><span class="ql-ui" contenteditable="false"></span>Aisyah yang memiliki arti gadis cantik</li>
    <li data-list="ordered"><span class="ql-ui" contenteditable="false"></span>Andina yang memiliki arti cantik</li>
    <li data-list="ordered"><span class="ql-ui" contenteditable="false"></span>Anindya yang memiliki arti sempurna</li>
    <li data-list="ordered"><span class="ql-ui" contenteditable="false"></span>Amisha yang memiliki arti cantik dengan hati yang baik</li>
    <li data-list="ordered"><span class="ql-ui" contenteditable="false"></span>Aini yang memiliki arti musim semi</li>
    <li data-list="ordered"><span class="ql-ui" contenteditable="false"></span>Aurora yang memiliki arti fajar</li>
    <li data-list="ordered"><span class="ql-ui" contenteditable="false"></span>Arawinda yang memiliki arti teratai</li>
    <li data-list="ordered"><span class="ql-ui" contenteditable="false"></span>Aruna yang memiliki arti merah, fajar</li>
    <li data-list="ordered"><span class="ql-ui" contenteditable="false"></span>Asoka yang memiliki arti bunga</li>
    <li data-list="ordered"><span class="ql-ui" contenteditable="false"></span>Asri yang memiliki arti indah dan sedap dipandang</li>
    <li data-list="ordered"><span class="ql-ui" contenteditable="false"></span>Ayu yang memiliki arti cantik</li>
    <li data-list="ordered"><span class="ql-ui" contenteditable="false"></span>Ayudisha yang memiliki arti dewi yang cantik</li>
    <li data-list="ordered"><span class="ql-ui" contenteditable="false"></span>Bonita yang memiliki arti cantik</li>
    <li data-list="ordered"><span class="ql-ui" contenteditable="false"></span>Batari yang memiliki arti wajahnya seperti bidadari</li>
    <li data-list="ordered"><span class="ql-ui" contenteditable="false"></span>Binar yang memiliki arti bersinar</li>
    <li data-list="ordered"><span class="ql-ui" contenteditable="false"></span>Bintang yang memiliki arti bintang</li>
    <li data-list="ordered"><span class="ql-ui" contenteditable="false"></span>Bulan yang memiliki arti penerang</li>
    <li data-list="ordered"><span class="ql-ui" contenteditable="false"></span>Bethari yang memiliki arti dewi</li>
    <li data-list="ordered"><span class="ql-ui" contenteditable="false"></span>Chaesa yang memiliki arti cahaya</li>
    <li data-list="ordered"><span class="ql-ui" contenteditable="false"></span>Cahaya yang memiliki arti bersinar</li>
    <li data-list="ordered"><span class="ql-ui" contenteditable="false"></span>Chayu yang memiliki arti mengagumkan</li>
    <li data-list="ordered"><span class="ql-ui" contenteditable="false"></span>Cahaya yang memiliki arti yang menerangi, kilau cahaya</li>
    <li data-list="ordered"><span class="ql-ui" contenteditable="false"></span>Candramaya yang memiliki arti cantik bagai bulan purnama</li>
    <li data-list="ordered"><span class="ql-ui" contenteditable="false"></span>Cempaka yang memiliki arti nama bunga</li>
    <li data-list="ordered"><span class="ql-ui" contenteditable="false"></span>Citra yang memiliki arti sempurna</li>
    <li data-list="ordered"><span class="ql-ui" contenteditable="false"></span>Carissa yang memiliki arti anggun</li>
    <li data-list="ordered"><span class="ql-ui" contenteditable="false"></span>Danastri yang memiliki arti anak yang cantik</li>
    <li data-list="ordered"><span class="ql-ui" contenteditable="false"></span>Diah yang memiliki arti anak yang cantik</li>
    <li data-list="ordered"><span class="ql-ui" contenteditable="false"></span>Dina yang memiliki arti dewi kecantikan</li>
    <li data-list="ordered"><span class="ql-ui" contenteditable="false"></span>Dhatu yang memiliki arti anak yang anggun seperti ratu</li>
    <li data-list="ordered"><span class="ql-ui" contenteditable="false"></span>Dania yang memiliki arti karunia Allah, cantik</li>
    <li data-list="ordered"><span class="ql-ui" contenteditable="false"></span>Dionne yang memiliki arti ratu</li>
    <li data-list="ordered"><span class="ql-ui" contenteditable="false"></span>Endah yang memiliki arti cantik</li>
    <li data-list="ordered"><span class="ql-ui" contenteditable="false"></span>Elok yang memiliki arti cantik</li>
    <li data-list="ordered"><span class="ql-ui" contenteditable="false"></span>Endah yang memiliki arti cantik</li>
    <li data-list="ordered"><span class="ql-ui" contenteditable="false"></span>Erianthe yang memiliki arti keindahan</li>
    <li data-list="ordered"><span class="ql-ui" contenteditable="false"></span>Fara yang memiliki arti cantik dan gembira</li>
    <li data-list="ordered"><span class="ql-ui" contenteditable="false"></span>Freya yang memiliki arti dewi cinta dan kecantikan</li>
    <li data-list="ordered"><span class="ql-ui" contenteditable="false"></span>Grace yang memiliki arti anugerah yang cantik dan murah hati</li>
    <li data-list="ordered"><span class="ql-ui" contenteditable="false"></span>Hayu yang memiliki arti cantik</li>
    <li data-list="ordered"><span class="ql-ui" contenteditable="false"></span>Ilona yang memiliki arti cahaya terang</li>
    <li data-list="ordered"><span class="ql-ui" contenteditable="false"></span>Ina yang memiliki arti matahari di sore hari</li>
    <li data-list="ordered"><span class="ql-ui" contenteditable="false"></span>Indah yang memiliki arti cantik</li>
    <li data-list="ordered"><span class="ql-ui" contenteditable="false"></span>Indri yang memiliki arti cantik</li>
    <li data-list="ordered"><span class="ql-ui" contenteditable="false"></span>Intan yang memiliki arti batu permata</li>
    <li data-list="ordered"><span class="ql-ui" contenteditable="false"></span>Jamila yang memiliki arti cantik</li>
    <li data-list="ordered"><span class="ql-ui" contenteditable="false"></span>Kaya yang memiliki arti mata air</li>
    <li data-list="ordered"><span class="ql-ui" contenteditable="false"></span>Kanissa yang memiliki arti seseorang yang memiliki mata yang cantik</li>
    <li data-list="ordered"><span class="ql-ui" contenteditable="false"></span>Kemala yang memiliki arti batu cantik</li>
    <li data-list="ordered"><span class="ql-ui" contenteditable="false"></span>Kamala yang memiliki arti teratai</li>
    <li data-list="ordered"><span class="ql-ui" contenteditable="false"></span>Kana yang memiliki arti nama bunga</li>
    <li data-list="ordered"><span class="ql-ui" contenteditable="false"></span>Keinan yang memiliki arti lagu yang indah</li>
    <li data-list="ordered"><span class="ql-ui" contenteditable="false"></span>Kirana yang memiliki arti sinar matahari</li>
    <li data-list="ordered"><span class="ql-ui" contenteditable="false"></span>Kemuning yang memiliki arti bunga kuning</li>
    <li data-list="ordered"><span class="ql-ui" contenteditable="false"></span>Kirana yang memiliki arti cahaya yang terang</li>
    <li data-list="ordered"><span class="ql-ui" contenteditable="false"></span>Kaila yang memiliki arti mahkota</li>
    <li data-list="ordered"><span class="ql-ui" contenteditable="false"></span>Laksmi yang memiliki arti cantik, molek</li>
    <li data-list="ordered"><span class="ql-ui" contenteditable="false"></span>Lina yang memiliki arti gadis cantik dan lembut</li>
    <li data-list="ordered"><span class="ql-ui" contenteditable="false"></span>Lili yang memiliki arti nama bunga</li>
    <li data-list="ordered"><span class="ql-ui" contenteditable="false"></span>Lavanya yang memiliki arti gadis yang cantik</li>
    <li data-list="ordered"><span class="ql-ui" contenteditable="false"></span>Legi yang memiliki arti manis</li>
    <li data-list="ordered"><span class="ql-ui" contenteditable="false"></span>Mawar yang memiliki arti bunga</li>
    <li data-list="ordered"><span class="ql-ui" contenteditable="false"></span>Melati yang memiliki arti nama bunga</li>
    <li data-list="ordered"><span class="ql-ui" contenteditable="false"></span>Mentari yang memiliki arti matahari</li>
    <li data-list="ordered"><span class="ql-ui" contenteditable="false"></span>Mika yang memiliki arti kecantikan yang terus meningkat</li>
    <li data-list="ordered"><span class="ql-ui" contenteditable="false"></span>Mirah yang memiliki arti batu permata</li>
    <li data-list="ordered"><span class="ql-ui" contenteditable="false"></span>Mustika yang memiliki arti batu mulia</li>
    <li data-list="ordered"><span class="ql-ui" contenteditable="false"></span>Naura yang memiliki arti cahaya yang bersinar terang</li>
    <li data-list="ordered"><span class="ql-ui" contenteditable="false"></span>Nayana yang memiliki arti mata yang cantik</li>
    <li data-list="ordered"><span class="ql-ui" contenteditable="false"></span>Puspa yang memiliki arti bunga</li>
    <li data-list="ordered"><span class="ql-ui" contenteditable="false"></span>Putri yang memiliki arti wanita, anak dari raja</li>
    <li data-list="ordered"><span class="ql-ui" contenteditable="false"></span>Puspita yang memiliki arti seorang perempuan memiliki kualitas</li>
    <li data-list="ordered"><span class="ql-ui" contenteditable="false"></span>Ratih yang memiliki arti dewi kecantikan</li>
    <li data-list="ordered"><span class="ql-ui" contenteditable="false"></span>Rania yang memiliki arti putri yang cantik dan mempesona</li>
    <li data-list="ordered"><span class="ql-ui" contenteditable="false"></span>Ranupatma yang memiliki arti bunga teratai</li>
    <li data-list="ordered"><span class="ql-ui" contenteditable="false"></span>Rara yang memiliki arti gadis</li>
    <li data-list="ordered"><span class="ql-ui" contenteditable="false"></span>Rasmi yang memiliki arti anak yang cantik</li>
    <li data-list="ordered"><span class="ql-ui" contenteditable="false"></span>Ratih yang memiliki arti dewi kecantikan</li>
    <li data-list="ordered"><span class="ql-ui" contenteditable="false"></span>Ratimaya yang memiliki arti bayangan keindahan</li>
    <li data-list="ordered"><span class="ql-ui" contenteditable="false"></span>Rasha yang memiliki arti gadis cantik</li>
    <li data-list="ordered"><span class="ql-ui" contenteditable="false"></span>Rosa yang memiliki arti bunga mawar</li>
    <li data-list="ordered"><span class="ql-ui" contenteditable="false"></span>Sasmaya yang memiliki arti indah</li>
    <li data-list="ordered"><span class="ql-ui" contenteditable="false"></span>Shabila yang memiliki arti cantik</li>
    <li data-list="ordered"><span class="ql-ui" contenteditable="false"></span>Sekar yang memiliki arti bunga</li>
    <li data-list="ordered"><span class="ql-ui" contenteditable="false"></span>Syakila yang memiliki arti cantik rupawan</li>
    <li data-list="ordered"><span class="ql-ui" contenteditable="false"></span>Tarasari yang memiliki arti cantik bagai bunga</li>
    <li data-list="ordered"><span class="ql-ui" contenteditable="false"></span>Tabitha yang memiliki arti cantik atau karunia</li>
    <li data-list="ordered"><span class="ql-ui" contenteditable="false"></span>Tania yang memiliki arti ratu peri</li>
    <li data-list="ordered"><span class="ql-ui" contenteditable="false"></span>Tiara yang memiliki arti seorang ratu</li>
    <li data-list="ordered"><span class="ql-ui" contenteditable="false"></span>Taneesha yang memiliki arti ratu peri</li>
    <li data-list="ordered"><span class="ql-ui" contenteditable="false"></span>Zayanah yang memiliki arti yang cantik</li>
    <li data-list="ordered"><span class="ql-ui" contenteditable="false"></span>Zahiyyah yang memiliki arti bersinar</li>
    <li data-list="ordered"><span class="ql-ui" contenteditable="false"></span>Zahriyyah yang memiliki arti seperti bunga</li>
    <li data-list="ordered"><span class="ql-ui" contenteditable="false"></span>Zeina yang memiliki arti cantik</li>
    <li data-list="ordered"><span class="ql-ui" contenteditable="false"></span>Zuhaira yang memiliki arti bunga, berseri-seri, bercahaya</li>
    <li data-list="ordered"><span class="ql-ui" contenteditable="false"></span>Zahira yang memiliki arti cemerlang, bersinar</li>
    <li data-list="ordered"><span class="ql-ui" contenteditable="false"></span>Zaibunissa yang memiliki arti wanita cantik</li>
    <li data-list="ordered"><span class="ql-ui" contenteditable="false"></span>Zanitha yang memiliki arti anggun, lembut</li>
    <li data-list="ordered"><span class="ql-ui" contenteditable="false"></span>Zarina yang memiliki arti emas, ratu</li>
</ol>
<ol>
    <li data-list="ordered"><span class="ql-ui" contenteditable="false"></span>Adriani yang memiliki arti kuat dan teguh</li>
    <li data-list="ordered"><span class="ql-ui" contenteditable="false"></span>Airani yang memiliki arti berjiwa muda</li>
    <li data-list="ordered"><span class="ql-ui" contenteditable="false"></span>Amanda yang memiliki arti perempuan yang penuh cinta</li>
    <li data-list="ordered"><span class="ql-ui" contenteditable="false"></span>Agni yang memiliki arti kobaran api penyemangat</li>
    <li data-list="ordered"><span class="ql-ui" contenteditable="false"></span>Aida yang memiliki arti hadiah yang berharga</li>
    <li data-list="ordered"><span class="ql-ui" contenteditable="false"></span>Alin yang memiliki arti pembawa cahaya</li>
    <li data-list="ordered"><span class="ql-ui" contenteditable="false"></span>Alisha yang memiliki arti dilindungi Tuhan</li>
    <li data-list="ordered"><span class="ql-ui" contenteditable="false"></span>Adinda yang memiliki arti yang tersayang</li>
    <li data-list="ordered"><span class="ql-ui" contenteditable="false"></span>Aqisha yang memiliki arti berkah Tuhan</li>
    <li data-list="ordered"><span class="ql-ui" contenteditable="false"></span>Ayunda yang memiliki arti anak tertua</li>
    <li data-list="ordered"><span class="ql-ui" contenteditable="false"></span>April yang memiliki arti yang lahir di bulan April</li>
    <li data-list="ordered"><span class="ql-ui" contenteditable="false"></span>Arsyana yang memiliki arti selalu bergembira</li>
    <li data-list="ordered"><span class="ql-ui" contenteditable="false"></span>Aulia yang memiliki arti orang yang suci</li>
    <li data-list="ordered"><span class="ql-ui" contenteditable="false"></span>Athalia yang memiliki arti keagungan Tuhan.</li>
    <li data-list="ordered"><span class="ql-ui" contenteditable="false"></span>Damara yang memiliki arti perempuan kuat</li>
    <li data-list="ordered"><span class="ql-ui" contenteditable="false"></span>Diajeng yang memiliki arti yang tersayang</li>
    <li data-list="ordered"><span class="ql-ui" contenteditable="false"></span>Eka yang memiliki arti anak pertama</li>
    <li data-list="ordered"><span class="ql-ui" contenteditable="false"></span>Estiana yang memiliki arti memiliki cita-cita</li>
    <li data-list="ordered"><span class="ql-ui" contenteditable="false"></span>Eufrasia yang memiliki arti dia yang penuh dengan sukacita</li>
    <li data-list="ordered"><span class="ql-ui" contenteditable="false"></span>Eudora yang memiliki arti hadiah yang murah hati</li>
    <li data-list="ordered"><span class="ql-ui" contenteditable="false"></span>Esme yang memiliki arti pelindung yang baik</li>
    <li data-list="ordered"><span class="ql-ui" contenteditable="false"></span>Fredella yang memiliki arti pembawa kedamaian</li>
    <li data-list="ordered"><span class="ql-ui" contenteditable="false"></span>Fridianty yang memiliki arti kedamaian</li>
    <li data-list="ordered"><span class="ql-ui" contenteditable="false"></span>Giselda yang memiliki arti tanda kebahagiaan</li>
    <li data-list="ordered"><span class="ql-ui" contenteditable="false"></span>Gempita yang memiliki arti meriah</li>
    <li data-list="ordered"><span class="ql-ui" contenteditable="false"></span>Gwen yang memiliki arti diberkati</li>
    <li data-list="ordered"><span class="ql-ui" contenteditable="false"></span>Gwyneth yang memiliki arti diberkati</li>
    <li data-list="ordered"><span class="ql-ui" contenteditable="false"></span>Hasana yang memiliki arti nantinya akan berbahagia</li>
    <li data-list="ordered"><span class="ql-ui" contenteditable="false"></span>Hazel yang memiliki arti penuh semangat</li>
    <li data-list="ordered"><span class="ql-ui" contenteditable="false"></span>Heera yang memiliki arti berlian yang berharga</li>
    <li data-list="ordered"><span class="ql-ui" contenteditable="false"></span>Ida yang memiliki arti kedamaian dan kebahagiaan</li>
    <li data-list="ordered"><span class="ql-ui" contenteditable="false"></span>Ilma yang memiliki arti pelindung yang kuat</li>
    <li data-list="ordered"><span class="ql-ui" contenteditable="false"></span>Inka yang memiliki arti bumi yang kecil</li>
    <li data-list="ordered"><span class="ql-ui" contenteditable="false"></span>Ika yang memiliki arti anak pertama</li>
    <li data-list="ordered"><span class="ql-ui" contenteditable="false"></span>Indriaya yang memiliki arti pembawa kebahagiaan</li>
    <li data-list="ordered"><span class="ql-ui" contenteditable="false"></span>Isaura yang memiliki arti perempuan yang lembut</li>
    <li data-list="ordered"><span class="ql-ui" contenteditable="false"></span>Jeanice yang memiliki arti putih dan lembut</li>
    <li data-list="ordered"><span class="ql-ui" contenteditable="false"></span>Juli yang memiliki arti seorang anak yang lahir di bulan Juli dengan selamat</li>
    <li data-list="ordered"><span class="ql-ui" contenteditable="false"></span>Juni yang memiliki arti seorang anak yang lahir di bulan Juni dengan selamat</li>
    <li data-list="ordered"><span class="ql-ui" contenteditable="false"></span>Kani yang memiliki arti yang terbaik</li>
    <li data-list="ordered"><span class="ql-ui" contenteditable="false"></span>Karina yang memiliki arti perempuan yang suci</li>
    <li data-list="ordered"><span class="ql-ui" contenteditable="false"></span>Kartana yang memiliki arti memiliki tatanan yang baik</li>
    <li data-list="ordered"><span class="ql-ui" contenteditable="false"></span>Kasidya yang memiliki arti melestarikan cinta orang tua</li>
    <li data-list="ordered"><span class="ql-ui" contenteditable="false"></span>Kasih yang memiliki arti perasaan sayang</li>
    <li data-list="ordered"><span class="ql-ui" contenteditable="false"></span>Katriona yang memiliki arti pemimpin yang abadi</li>
    <li data-list="ordered"><span class="ql-ui" contenteditable="false"></span>Lalita yang memiliki arti terus bergerak</li>
    <li data-list="ordered"><span class="ql-ui" contenteditable="false"></span>Lanita yang memiliki arti mengabadikan cinta</li>
    <li data-list="ordered"><span class="ql-ui" contenteditable="false"></span>Laya yang memiliki arti bertempat tinggal</li>
    <li data-list="ordered"><span class="ql-ui" contenteditable="false"></span>Lelana yang memiliki arti punya kelebihan</li>
    <li data-list="ordered"><span class="ql-ui" contenteditable="false"></span>Lisa yang memiliki arti janji Tuhan</li>
    <li data-list="ordered"><span class="ql-ui" contenteditable="false"></span>Lanita yang memiliki arti mengabadikan cinta</li>
    <li data-list="ordered"><span class="ql-ui" contenteditable="false"></span>Laya yang memiliki arti bertempat tinggal</li>
    <li data-list="ordered"><span class="ql-ui" contenteditable="false"></span>Manda yang memiliki arti lemah lembut</li>
    <li data-list="ordered"><span class="ql-ui" contenteditable="false"></span>Maya yang memiliki arti nama seorang dewi, air</li>
    <li data-list="ordered"><span class="ql-ui" contenteditable="false"></span>Marieline yang memiliki arti pejuang yang dicintai</li>
    <li data-list="ordered"><span class="ql-ui" contenteditable="false"></span>Mutiara yang memiliki arti sesuatu yang berharga</li>
    <li data-list="ordered"><span class="ql-ui" contenteditable="false"></span>Myeisha yang memiliki arti kehidupan yang baik</li>
    <li data-list="ordered"><span class="ql-ui" contenteditable="false"></span>Naira yang memiliki arti bercahaya, brilian, penuh cahaya</li>
    <li data-list="ordered"><span class="ql-ui" contenteditable="false"></span>Novarina yang memiliki arti lahir di bulan November dengan selamat</li>
    <li data-list="ordered"><span class="ql-ui" contenteditable="false"></span>Oktaviasari yang memiliki arti lahir di bulan Oktober dengan selamat</li>
    <li data-list="ordered"><span class="ql-ui" contenteditable="false"></span>Purnama yang memiliki arti bulan yang seutuhnya</li>
    <li data-list="ordered"><span class="ql-ui" contenteditable="false"></span>Ratu yang memiliki arti wanita yang berkuasa</li>
    <li data-list="ordered"><span class="ql-ui" contenteditable="false"></span>Ramadhani yang memiliki arti bulan Ramadhan</li>
    <li data-list="ordered"><span class="ql-ui" contenteditable="false"></span>Siti yang memiliki arti perempuan mulia.</li>
    <li data-list="ordered"><span class="ql-ui" contenteditable="false"></span>Suci yang memiliki arti tanpa dosa, bersih</li>
    <li data-list="ordered"><span class="ql-ui" contenteditable="false"></span>Salwa yang memiliki arti pelipur lara</li>
    <li data-list="ordered"><span class="ql-ui" contenteditable="false"></span>Samaiya yang memiliki arti orang yang memaafkan</li>
    <li data-list="ordered"><span class="ql-ui" contenteditable="false"></span>Stephanie yang memiliki arti terhormat</li>
    <li data-list="ordered"><span class="ql-ui" contenteditable="false"></span>Thya yang memiliki arti hadiah dari Tuhan</li>
    <li data-list="ordered"><span class="ql-ui" contenteditable="false"></span>Tisna yang memiliki arti cinta dan kasih sayang</li>
    <li data-list="ordered"><span class="ql-ui" contenteditable="false"></span>Tiwi yang memiliki arti anak yang punya kelebihan</li>
    <li data-list="ordered"><span class="ql-ui" contenteditable="false"></span>Thea yang memiliki arti berkat Tuhan</li>
    <li data-list="ordered"><span class="ql-ui" contenteditable="false"></span>Teodora yang memiliki arti dikirim Tuhan</li>
    <li data-list="ordered"><span class="ql-ui" contenteditable="false"></span>Theodora yang memiliki arti Tuhan telah menjawab doa</li>
    <li data-list="ordered"><span class="ql-ui" contenteditable="false"></span>Talitha yang memiliki arti anak-anak, wanita muda</li>
    <li data-list="ordered"><span class="ql-ui" contenteditable="false"></span>Tamara yang memiliki arti pohon palem</li>
    <li data-list="ordered"><span class="ql-ui" contenteditable="false"></span>Taraji yang memiliki arti harapan dan keyakinan</li>
    <li data-list="ordered"><span class="ql-ui" contenteditable="false"></span>Thalia yang memiliki arti embun dari Tuhan</li>
    <li data-list="ordered"><span class="ql-ui" contenteditable="false"></span>Thania yang memiliki arti kesempatan berbahagia</li>
    <li data-list="ordered"><span class="ql-ui" contenteditable="false"></span>Theofani yang memiliki arti penampakan Tuhan</li>
    <li data-list="ordered"><span class="ql-ui" contenteditable="false"></span>Valeria yang memiliki arti kokoh</li>
    <li data-list="ordered"><span class="ql-ui" contenteditable="false"></span>Valerie yang memiliki arti kekuatan</li>
    <li data-list="ordered"><span class="ql-ui" contenteditable="false"></span>Valery yang memiliki arti kuat</li>
    <li data-list="ordered"><span class="ql-ui" contenteditable="false"></span>Valen yang memiliki arti kuat dan sehat</li>
    <li data-list="ordered"><span class="ql-ui" contenteditable="false"></span>Valencia yang memiliki arti kekuatan dan berani</li>
    <li data-list="ordered"><span class="ql-ui" contenteditable="false"></span>Vania yang memiliki arti hadiah dari Tuhan</li>
    <li data-list="ordered"><span class="ql-ui" contenteditable="false"></span>Widi yang memiliki arti aturan</li>
    <li data-list="ordered"><span class="ql-ui" contenteditable="false"></span>Widia yang memiliki arti ilmu pengetahuan</li>
    <li data-list="ordered"><span class="ql-ui" contenteditable="false"></span>Wiyana yang memiliki arti pemimpin</li>
    <li data-list="ordered"><span class="ql-ui" contenteditable="false"></span>Wulan yang memiliki arti bulan</li>
    <li data-list="ordered"><span class="ql-ui" contenteditable="false"></span>Wulandari yang memiliki arti bulan purnama</li>
    <li data-list="ordered"><span class="ql-ui" contenteditable="false"></span>Yulianti yang memiliki arti yang lahir di bulan Juli</li>
    <li data-list="ordered"><span class="ql-ui" contenteditable="false"></span>Yuni yang memiliki arti anak yang menghormati orang tua</li>
    <li data-list="ordered"><span class="ql-ui" contenteditable="false"></span>Yuna yang memiliki arti menginginkan</li>
    <li data-list="ordered"><span class="ql-ui" contenteditable="false"></span>Yunita yang memiliki arti penyayang</li>
    <li data-list="ordered"><span class="ql-ui" contenteditable="false"></span>Zafia yang memiliki arti Batu safir</li>
    <li data-list="ordered"><span class="ql-ui" contenteditable="false"></span>Zoraya yang memiliki arti berharga</li>
    <li data-list="ordered"><span class="ql-ui" contenteditable="false"></span>Zagita yang memiliki arti anak perempuan berbintang Sagitarius</li>
    <li data-list="ordered"><span class="ql-ui" contenteditable="false"></span>Zanita yang memiliki arti sukses</li>
    <li data-list="ordered"><span class="ql-ui" contenteditable="false"></span>Zoriona yang memiliki arti kebahagiaan</li>
</ol>


<ol>
    <li>Aafa Haya Mustafa bermakna wanita pemaaf yang menjadi terpilih karena sopan santun</li>
    <li>Abidah Nur Aiza bermakna anak perempuan terhormat yang bercahaya karena gemar beribadah</li>
    <li>Adiva Arsyila Savina bermakna anak cantik yang baik hati dan memiliki kehidupan yang tenteram serta lembut&nbsp;hatinya</li>
    <li>Afiqa Zaina Hulwah bermakna anak perempuan cantik yang manis dalam bersikap dan cerdas dalam berpikir</li>
    <li>Afsheen Tsurayya Zahwa bermakna anak perempuan cantik seperti kumpulan bintang yang bersinar di langit</li>
    <li>Aiba Noor Rahim bermakna gadis secantik bunga yang penuh kasih sayang</li>
    <li>Ainuha Shaliha Muhyii bermakna perempuan saliha&nbsp;dengan tatapan mata yang penuh kehidupan</li>
    <li>Alaniah Adara Amalina bermakna anak perempuan berumur panjang dengan kecantikan wajah dan kemurahan hati yang nyata</li>
    <li>Alifa Zahra Fitriani bermakna gadis suci yang lembut dan sabar hatinya seperti bunga</li>
    <li>Alifah Sakhi Zayn bermakna perempuan cantik yang ramah dan memiliki hati yang dermawan</li>
    <li>Alifia Rahmawati Fazila bermakna limpahan rahmat berupa perempuan yang lembut dan mengesankan</li>
    <li>Alifiya Madia Nadhifah bermakna anak perempuan pertama yang suci dan terpuji</li>
    <li>Aliza Sumehra Dzulhijjah bermakna gadis cantik dan ceria yang lahir di bulan Zulhijjah</li>
    <li>Almashyra Hayfa Shabiyyah bermakna gadis kecil yang rupawan dan gemar akan kemasyhuran serta kebajikan</li>
    <li>Alya Nyfa Gaddafi bermakna dari gadis yang diturunkan dari surga oleh Tuhan-nya sebagai hadiah bagi orang tuanya</li>
    <li>Alzan Faeqa Amanda bermakna wanita yang banyak disukai banyak orang karena berparas anggun dan jelita</li>
    <li>Amal Zia Abbas bermakna wanita pembawa cahaya harapan yang penuh keberanian</li>
    <li>Amaya Ama Nasser bermakna gadis pemenang yang bersifat manis secara lahiriah</li>
    <li>Ameera Kareema Aqeela bermakna putri yang murah hati dan beruntung</li>
    <li>Amel Mahfuz Fariha bermakna perempuan yang menjaga amal baiknya dengan kesenangan</li>
    <li>Aminta Arles Fayda bermakna wanita pelindung yang maha mulia dan suka menolong</li>
    <li>Amira Hayfa Nabila bermakna putri yang rupawan dan pintar</li>
    <li>Anabia Sabeel Khairiyah bermakna jalan masuk menuju surga yang bersifat baik</li>
    <li>Anaya Ayat Hafeez bermakna penjaga wanita yang diberkati Allah dengan tanda-tanda kebaikan</li>
    <li>Anindita Kaamilah Keisha bermakna wanita sempurna yang tidak memiliki kekurangan sedikit pun</li>
    <li>Aqeela Sukma Nimah bermakna wanita bangsawan yang diberi Tuhan dan diberkati</li>
    <li>Aresha Malayeka Alzena bermakna wanita yang cantik seperti bidadari yang selalu berada di bawah naungan Allah SWT</li>
    <li>Asfa Ayan Sader bermakna gadis cantik yang diberkati dengan kekuatan sebagai pemberian dari Allah</li>
    <li>Asheeqa Ahlam Zayn bermakna wanita cantik yang dicintai dan penuh cita-cita</li>
    <li>Asima Fathiya Dzulhijjah bermakna pelindung wanita yang diliputi kemenangan dan terlahir di bulan Zulhijah</li>
    <li>Ata Hakim Alina bermakna wanita yang menyembuhi rakyat dengan keadilan sebagai anugerah terbaik</li>
    <li>Atiya Zahra Nazira bermakna gadis yang dikaruniai dengan wajah secantik bunga</li>
    <li>Aulia Nur Hikmah bermakna pemimpin perempuan yang berpengetahuan luas</li>
    <li>Azka Farah Aziza bermakna perempuan terhormat yang bahagia dan dicintai</li>
    <li>Azka Hayfa Almeera bermakna seorang putri yang cantik dan cerdas</li>
    <li>Baby Yasirah Rahim bermakna anak perempuan yang diberi kemudahan oleh Tuhannya yang Maha Penyayang</li>
    <li>Badria Siti Zahidah bermakna wanita dengan kekukuhan hati luar biasa yang menjadi sumber kebahagiaan</li>
    <li>Badyah Amaal Asheeta bermakna wanita mengagumkan yang membawa harapan baik di dunia</li>
    <li>Baha Zayma Anisah bermakna pemimpin wanita yang baik dan mengagumkan</li>
    <li>Bahar Jauharah Rania bermakna wanita terhormat dengan kecantikan seindah seperti bunga dari permata yang mekar di musim semi</li>
    <li>Baheera Ayana Rizqiana bermakna gadis secantik dan memesona seperti&nbsp;bunga yang dilimpahkan rezeki</li>
    <li>Bahiyya Amal Hidayah bermakna wanita dengan kecantikan luar biasa yang senang berbuat baik dan menjadi hidayah bagi orang lain</li>
    <li>Baihati Nasywa Bashir bermakna gadis yang datang membawa keberuntungan dan kegembiraan dari Yang Maha Melihat</li>
    <li>Bakhitah Fathimah Safiyyah bermakna teman wanita cantik yang diberkati dengan keberuntungan dan kesucian hati</li>
    <li>Balia Hayyu Dewi bermakna wanita cantik yang ditenteramkan hidupnya oleh Tuhannya</li>
    <li>Balighah Nadira Latifah bermakna wanita istimewa dengan kedewasaan yang langka serta hati yang baik dan lembut</li>
    <li>Balqis Dhariah Afinah bermakna seorang ratu pemaaf yang berhati lemah lembut</li>
    <li>Balqis Raidah Almaira bermakna anak yang kelak jadi pemimpin ratu atau putri</li>
    <li>Balqis Tsiqlah Nafisah bermakna perempuan cantik yang menjadi harta paling berharga</li>
    <li>Banafsha Alula Zahira bermakna wanita yang saliha, dermawan dan cantik berseri serta merupakan anak pertama</li>
    <li>Banafsha Sanari Nabiha bermakna wanita cantik yang cerdas, saleh, dan dermawan</li>
    <li>Baninah Shifa Qanita bermakna wanita rendah hati yang taat pada agamanya dan membawa kebahagiaan yang menyembuhkan</li>
    <li>Baqirah Maryam Izzah bermakna wanita dengan kemuliaan tak terukur yang sangat bijaksana dalam bertindak</li>
    <li>Bari’ah Rana Lusiana bermakna wanita cantik cahaya keluarga yang dapat diandalkan</li>
    <li>Bariqah Amila Amany bermakna anak perempuan yang gigih meraih cita-citanya yang berkilau terang</li>
    <li>Barizah Naadiya Sohana bermakna perempuan cantik yang dapat menjadi pelopor dan menonjol dalam kepandaian</li>
    <li>Bashar Anha Mayra bermakna bulan penuh cinta yang muncul membawa kabar baik di waktu-waktu sulit</li>
    <li>Basheera Hena Rizqia bermakna anak secantik bunga yang lahir sebagai pembawa kabar baik dan rezeki</li>
    <li>Basimah Nazira Yaqin bermakna wanita dengan penglihatan baik yang senang tersenyum dengan penuh keyakinan</li>
    <li>Basirah Rasya Ilhama bermakna wanita dengan keindahan menakjubkan yang berwawasan tajam dan penuh kebijaksanaan</li>
    <li>Basma Imani Kanizah bermakna perempuan muda yang diliputi kebahagiaan karena memiliki iman yang kuat</li>
    <li>Basmalah Fariza Haura bermakna wanita dengan cahaya yang bersinar dengan penuh kekuatan karena selalu mengingat Allah</li>
    <li>Bayyinah Jami Athaya bermakna hadiah dari Allah yang memiliki bukti-bukti kebaikan dalam hatinya</li>
    <li>Begum Aleena Islami bermakna ratu islam yang berparas cantik</li>
    <li>Bela Arum Damayanti bermakna bunga melati yang harum dan mendamaikan hati</li>
    <li>Benasir Afifa Aquela bermakna berbudi luhur, anggun, dan bijaksana</li>
    <li>Bilqis Adila Uzma bermakna ratu yang mulia dan hidup dalam kemegahan</li>
    <li>Busra Alima Najwa bermakna wanita secantik bunga mawar dengan pengetahuan yang sorot mata yang indah</li>
    <li>Bussaina Dhalili Dzakiyyah bermakna pemimpin yang cerdas, cantik, dan menarik di mata banyak orang</li>
    <li>Buthaina Anisa Zahira bermakna wanita cantik dan anggun dengan hati lembut yang bersinar seterang bintang yang suci</li>
    <li>Cahaya Amira Kirana bermakna pemimpin wanita dengan pengaruh yang membangkitkan banyak orang seperti cahaya pagi</li>
    <li>Cahaya Shabur Zakauha bermakna wanita yang sabar mencari ilmu dan memiliki kecerdasan yang bercahaya dari Tuhannya</li>
    <li>Caidensya Adira Zafira bermakna perempuan pemberani dengan hati indah yang berkilau cerah seperti permata</li>
    <li>Caliana Suniyyah Fazilla bermakna seorang putri yang bersinar dengan luar biasa</li>
    <li>Calida Athaya Armaria bermakna hadiah dari Tuhan berupa perempuan paling cantik yang selalu riang gembira</li>
    <li>Calista Anindya Zahra bermakna wanita dengan kecantikan tiada tara layaknya bunga harum yang bersinar</li>
    <li>Callia Nur Kamilia bermakna gadis cantik nan indah yang bercahaya sempurna</li>
    <li>Camelia Putri Azzahra bermakna gadis bangsawan secantik bunga camelia yang bersinar</li>
    <li>Cantika Najwa Basyirah bermakna wanita berwawasan luas dengan kecantikan yang tersembunyi</li>
    <li>Carabella Almira Azzahra bermakna gadis berwajah cantik yang memiliki kemuliaan hati dan kecerdasan yang melimpah</li>
    <li>Carenza Jumana Syifa bermakna gadis dengan kasih sayang yang menyembuhkan dan berlimpah seperti mutiara perak berharga</li>
    <li>Carissa Zulaiha Amani bermakna perempuan pembawa kedamaian hati yang indah seperti bunga</li>
    <li>Casilda Basma Inara bermakna anak yang pintar, berkarisma, murah senyum, dan pejuang</li>
    <li>Celiana Jumaira Haniya bermakna gadis cantik&nbsp;yang penuh kelembutan dan membawa kebahagiaan seperti hujan di malam hari</li>
    <li>Celina Hana Zahra bermakna wanita wangi dari surga dengan kebahagiaan yang membuat dirinya bersinar</li>
    <li>Celmira Fayruz Khirani bermakna anak yang baik, cantik seperti permata dan pintar</li>
    <li>Cerys Amira Alayna bermakna gadis cantik yang penuh kasih sayang dan memiliki kelembutan seperti matahari pagi</li>
    <li>Chaerunnisa Razqya Fakhriya bermakna wanita cantik yang membanggakan dan baik hati</li>
    <li>Charis Azzalea Naira bermakna wanita penuh kasih yang membanggakan seperti bunga indah dari surga</li>
    <li>Chayra Afsheen Hamiza bermakna bintang kecil yang bersinar membawa kebaikan kesopanan dalam kehidupannya</li>
    <li>Chayra Ameira Zuwaina bermakna pemimpin yang diberkati dengan kebaikan hati</li>
    <li>Chayra Awal Fayyola bermakna perempuan yang selalu memprioritaskan ajaran agamanya dalam kehidupannya</li>
    <li>Chayra Dwi Aulia bermakna gadis yang menjadi kekasih kedua Allah karena telah dimuliakan-Nya</li>
    <li>Cherika Nayyara Nazifa bermakna wanita dengan paras bercahaya yang bersinar seterang rembulan</li>
    <li>Cindy Fatimah Azzahra bermakna wanita terhormat dengan kecantikan yang bersinar seterang rembulan</li>
    <li>Cintara Zakiyah Rania bermakna ratu terhormat yang mencintai dengan penuh kemurnian</li>
    <li>Citra Hanifa Najla bermakna wanita cerdas bermata jeli yang seindah lukisan dan hidup dalam kebenaran</li>
    <li>Clara Humaira Qistina bermakna wanita dengan cahaya kecantikan berharga yang bersinar terang</li>
    <li>Clarita Zaynah Alisha bermakna perempuan berhati lembut dengan keindahan sejelas permata</li>
    <li>Clemira Rafifa Karima bermakna wanita murah hati yang memberi penerangan dengan akhlak baiknya</li>
    <li>Cordelia Rafani Nayara bermakna pemimpin wanita baik hati yang bahagia dan kaya raya</li>
    <li>Cornelia Jannah Insyirah bermakna gadis pemberani bertanduk yang diliputi kegembiraan mutlak dari surga</li>
    <li>Cynara Khansa Latifah bermakna pejuang wanita cantik berhati lemah lembut yang terlindungi karena ia&nbsp;saliha</li>
    <li>Cyra Nisa Aulia bermakna gadis saleh yang menjadi pelindung karena hatinya yang mulia</li>
    <li>Czarina Khairani Lutfia bermakna gadis berkedudukan tinggi yang baik hati dan dilimpahi dengan rezeki</li>
    <li>Daisha Zian Syafrina bermakna wanita kuat yang hidup dengan penuh kesabaran</li>
    <li>Dalila Aiza Bushra bermakna wanita berhati lemah lembut yang dihormati sebagai pembawa berita baik</li>
    <li>Dalila Kirana Azmi bermakna wanita cantik yang menjadi kekasih mentari yang teguh bersinar di pagi hari</li>
    <li>Damitsa Nur Aini bermakna perempuan yang berakhlak baik dan sopan yang terlihat cantik</li>
    <li>Danah Aliya Atiqah bermakna wanita cantik yang dimuliakan karena keanggunannya</li>
    <li>Danah Annisa Arshima bermakna anak perempuan anggun dan cerdas yang merupakan hadiah dari Allah</li>
    <li>Daneen Arisha Lashira bermakna seorang putri kuat yang sangat cerdas</li>
    <li>Danish Aza Shakila bermakna perempuan cantik rupawan yang bijaksana</li>
    <li>Darayani Izati Shabura bermakna wanita mulia yang menyadari bahwa Tuhannya yang Maha Penyabar akan selalu membimbingnya</li>
    <li>Daria Rusyda Saidah bermakna wanita pintar pemberi petunjuk kepada orang lain dan mendapat kebahagiaan</li>
    <li>Darra Lituhayu Sajadah bermakna anak perempuan secantik mutiara yang gemar sembahyang</li>
    <li>Darwish Hiza Anira bermakna wanita penjelajah yang tak kenal takut dan beruntung dalam hidupnya</li>
    <li>Dayana Faiza Arina bermakna anak perempuan yang kuat dan cekatan sangat berharga bagaikan permata</li>
    <li>Delkash Athifah Farihan bermakna perempuan cantik yang diliputi kegembiraan</li>
    <li>Delnaz Amina Jamila bermakna perempuan cantik yang dapat dipercaya dan dicintai</li>
    <li>Dewi Fathin Shidqia bermakna seorang perempuan yang mengagumkan dikarenakan kebenaran dan kejujuran dalam tiap ucapannya</li>
    <li>Dhaifah Keysha Salsabil bermakna nak perempuan yang dilahirkan dari kebeningan hati dan selalu dihormati banyak orang</li>
    <li>Dhiya Amani Putri bermakna putri bangsawan pembawa cahaya kedamaian yang bersinar terang</li>
    <li>Dhiyaa Amara Naima bermakna perempuan dengan kecantikan bersinar yang menyenangkan dan menenteramkan hati</li>
    <li>Dianah Hanifah Azizah bermakna wanita terhormat yang lurus agamanya</li>
    <li>Dianah Najiha Salsabila bermakna wanita sukses yang ahli dalam bidang agama dan akan mendapatkan kenikmatan surga</li>
    <li>Diandra Zivana Athalla bermakna prajurit yang meraih kemenangan dengan karunia Allah</li>
    <li>Dihan Shala Farzana bermakna wanita dengan kebijaksanaan&nbsp;setinggi gunung yang menyentuh surga</li>
    <li>Dila Muhibbah Azizah bermakna wanita cerdas dan pintar yang mencintai nilai-nilai kemuliaan</li>
    <li>Dilara Hanif Harika bermakna anak perempuan cantik berhati baik yang kuat menghadapi tantangan hidup</li>
    <li>Dina Aulia Rahma gadis yang disayangi dan menjadi kekasih Allah karena selalu berpegang teguh pada keyakinannya</li>
    <li>Dinar Kirana Anindita bermakna gadis bercahaya bagai bintang yang berharga</li>
    <li>Dinda Fahira Zahra bermakna adik perempuan dengan kecerdasan yang bersinar</li>
    <li>Disaya Hadi Rajwa bermakna gadis yang dibimbing menuju harapan hidup oleh Tuhannya yang Maha Pemberi Petunjuk</li>
    <li>Dua Raisa Djamilia bermakna pemimpin cantik yang muncul membawa harapan</li>
    <li>Durah Saiwa Fajr bermakna mutiara yang bersinar di waktu fajar</li>
    <li>Dwipa Larasati Kamila bermakna gadis yang sempurna dan berhati tenang karena berbudi luhur</li>
    <li>Dyra Khanza Abir bermakna wanita yang baik dan kuat hatinya</li>
    <li>Dzakiyyah Mehrunisa Shula bermakna wanita cantik, cerdas, dan bercahaya</li>
    <li>Dzihni Faqihah Firzana bermakna anak perempuan yang pintar dan memiliki pemahaman yang penuh kebijaksanaan</li>
    <li>Eartha Talitha Lathifah bermakna gadis penghuni bumi yang dianugerahi dengan hati yang lembut oleh Tuhannya</li>
    <li>Edina Nadzifa Nur bermakna wanita berhati suci yang selalu merasa bahagia karena dinaungi cahaya Tuhannya</li>
    <li>Eiliyah Najwa Raihanah bermakna perempuan yang terkenal baik dan cinta kepada Allah</li>
    <li>Eiliyah Radya Athalla bermakna gadis cantik yang penuh kasih sayang berkat karunia dan rida Allah</li>
    <li>Eira Hadi Alia bermakna wanita penyayang yang dimuliakan karena selalu mengutamakan kebenaran</li>
    <li>Eisha Humaira Kirana bermakna sinar mentari kemerahan yang menghidupkan banyak orang</li>
    <li>Elein Asher Myra bermakna anak manis dan bahagia yang bercahaya seterang obor</li>
    <li>Elesa Sienna Azhariah bermakna perempuan cantik yang elegan serta berani</li>
    <li>Elia Maliha Magda bermakna gadis cantik dan indah yang selalu bersemangat</li>
    <li>Elifah Nurul Marwa bermakna gadis yang membawa cahaya di atas bukit dan merasakan kebahagiaan karena cahaya Tuhannya</li>
    <li>Elijah Fatima Zahira bermakna perempuan lemah lembut dan pintar yang membawa sinar terang dalam kegelapan</li>
    <li>Elijah Shafa Tehzeeb bermakna perempuan muda yang bijaksana dan pintar</li>
    <li>Elina Jannah Maisarah bermakna wanita yang diberkati dengan cahaya kebahagiaan dari surga</li>
    <li>Elinda Rania Salsabila bermakna wanita berwajah cerah seperti air bulan yang mengalir dari sumber yang suci dan menghidupi</li>
    <li>Eliza Rifdatul Anam bermakna wanita berharga yang suka menolong sesama</li>
    <li>Elizah Alma Syahirah bermakna wanita terkenal yang jiwanya terpenuhi dengan sumpah kepada Tuhannya</li>
    <li>Elma Hanin Maisha bermakna perempuan cantik yang penuh kasih sayang dan rasa simpati</li>
    <li>Elvira Zahira Salma bermakna wanita dengan keberanian yang bersinar terang karena membawa kedamaian</li>
    <li>Emelda Aisyah Nadhifa bermakna gadis anggun berhati bersih yang disayangi Tuhan dengan penuh kesucian</li>
    <li>Emilia Sarah Ziannisa bermakna putri pekerja keras dengan semangat yang berkobar</li>
    <li>Eram Dawoud Myra bermakna teman perempuan tercinta yang diberikan cahaya dari surga</li>
    <li>Erika Fathimah Luthfiyah bermakna gadis dengan iman kuat yang membawa keberkahan dan kelembutan yang terpancar</li>
    <li>Erina Fiza Amanita bermakna angin yang bertiup anggun pembawa kedamaian</li>
    <li>Erina Syifa Muthmainnah bermakna perempuan cantik sebagai obat ketentraman manusia</li>
    <li>Erma Marissa Dzatil bermakna gadis pejuang keberanian dengan keanggunan dan kelembutan hati yang menarik perhatian</li>
    <li>Eshaal Syahla Umaiza bermakna anak yang cantik seperti bunga di surga dan memiliki mata kebiru-biruan</li>
    <li>Eshal Zayna Namiera bermakna bunga dari surga dengan kecantikan yang berlipat ganda</li>
    <li>Esti Nahla Aisyah bermakna wanita yang hidup dalam kesucian dan menjadi sumber kebahagiaan sebagai berkat dari Tuhannya</li>
    <li>Euphrasia Sakinah Zahwa bermakna gadis pembawa kedamaian dengan keceriaan dan kecantikan yang bercahaya</li>
    <li>Euthalia Zalfa Rizqia bermakna gadis pembawa keindahan dan kesejukan yang diberkati dengan rezeki yang melimpah</li>
    <li>Eva Hadid Kaira bermakna wanita kuat yang memiliki kehidupan manis</li>
    <li>Eva Mayra Laghmani bermakna sinar rembulan yang cerah dan menyinari kehidupan</li>
    <li>Eyana Saina Farouq bermakna putri penuh kasih sayang yang rela memaafkan semua orang</li>
    <li>Ezzah Sajida Muthiah bermakna perempuan yang hormat kepada orang lain dan taat bersujud kepada tuhannya</li>
    <li>Ezzulia Farida Najma bermakna wanita pembawa keceriaan dengan kebaikan yang bersinar seterang bintang sehingga ia menjadi suri tauladan</li>
</ol>
<ol>
    <li>Faatima Ereshva Adha bermakna wanita sempurna dan penuh kebenaran yang lahir di hari Idul Adha</li>
    <li>Faatina Raheema Rizqia bermakna&nbsp;gadis pembawa rezeki yang menawan serta penyayang</li>
    <li>Fadheela Ambar Zuhriyah bermakna wanita yang baik hatinya dan harum tubuhnya seperti bunga</li>
    <li>Fadhila Kabsya Munirah bermakna pemimpin perempuan yang mulia, unggul, dan mendapatkan cahaya</li>
    <li>Fadiyah Kasiya Rahmah bermakna perempuan mulia yang menyelamatkan orang lain dan pengasih</li>
    <li>Fahma Adawiyah Mutsaqqaf bermakna perempuan yang mendekatkan diri kepada tuhan, tinggi pemahaman, dan berwawasan luas</li>
    <li>Faida Qaniah Azhari bermakna perempuan cantik yang taat kepada Allah dan mendapat keuntungan</li>
    <li>Faidha Zharufa Atikah bermakna perempuan cantik yang banyak berbuat kebaikan serta mulia</li>
    <li>Faiqa Amalia Arifah bermakna wanita yang memiliki cita-cita tinggi dan dekat dengan Allah</li>
    <li>Faiza Syifa Muthiah bermakna wanita yang bahagia dan menjadi obat bagi orang lain serta taat beribadah</li>
    <li>Fakhirah Rahma Ilhami bermakna wanita dermawan yang menjadi kebanggaan keluarga dan mendapat petunjuk Allah</li>
    <li>Fakhriya Athalla Putri bermakna putri karunia Allah yang membanggakan</li>
    <li>Farah Alzena Noura bermakna wanita yang hidup bahagia dan penuh semangat</li>
    <li>Farah Saqqaf Zyana bermakna wanita mulia yang diberkati dengan kepandaian dari surga</li>
    <li>Farica Ivana Zhahir bermakna perempuan yang dikarunia dengan kedamaian hati dan kemuliaan hakiki dari Tuhannya</li>
    <li>Farida Asha Shirin bermakna perempuan unik dan menawan</li>
    <li>Fariha Nur Fajrina bermakna wanita yang selalu bangkit dari keterpurukan dengan kegembiraan karena cahaya Tuhannya</li>
    <li>Farizah Arafah Atifa bermakna perempuan terpilih yang dipandang baik kelak ketika di padang arafah</li>
    <li>Farwa Nada Nurazzahrah bermakna anak yang diberkahi dengan kekayaan, kebahagiaan, namun tetap murah hati</li>
    <li>Farzana Adeeva Banafsha bermakna wanita yang saliha, dermawan, lemah lembut, bijak, dan pandai</li>
    <li>Fatima Ayra Shofia bermakna perempuan memesona yang cerdas dan dihormati</li>
    <li>Fatima Farah Almiraa bermakna putri yang mencapai kesuksesan dan kegembiraan</li>
    <li>Fatina Rizqi Ameena bermakna perempuan yang menawan, setia, dan membawa rezeki</li>
    <li>Faustina Ama Aadila bermakna perempuan pembawa rezeki yang murah hati, pemaaf, dan bermoral tinggi</li>
    <li>Fayza Kulla Azmina bermakna perempuan yang senantiasa menang di tiap zaman</li>
    <li>Filanna Aaliyah Zuleika bermakna kebangkitan yang adil dan penuh kasih</li>
    <li>Fildzah Atina Hafawati bermakna belahan hati yang datang dengan sambutan yang meriah</li>
    <li>Fiona Zea Hakimah bermakna wanita dengan sinar putih yang selalu berlaku adil layaknya seorang hakim</li>
    <li>Fira Azucena Syafazea bermakna ibu baik hati yang sopan dan memberikan manfaat berupa cahaya yang bersinar</li>
    <li>Firyal Aufa Gauthiah bermakna seorang putri yang lebih cepat mendapat pertolongan</li>
    <li>Fitria Hanifa Shafiyah bermakna wanita berhati suci bersih yang dituntun ke jalan yang terang benderang</li>
    <li>Fitria Rani Shaima bermakna pemimpin baik hati yang menjaga kesuciannya</li>
    <li>Fitria Soraya Alfathunisa bermakna gadis suci dan lembut dengan kekayaan harta yang melimpah</li>
    <li>Fiya Safa Kader bermakna wanita ambisius yang berkuasa karena jelas dalam memimpin</li>
    <li>Freya Adibatul Hasanah bermakna wanita mulia dengan akhlak yang baik</li>
    <li>Gabina Fareeha Eira bermakna wanita bahagia yang kuat dan tegar dalam berjuang di hidupnya</li>
    <li>Gadis Rasyi Dzakiyah bermakna wanita yang dikaruniai dengan kecerdasan dari Tuhannya yang Maha Pandai</li>
    <li>Galila Aretha Saree bermakna wanita mulia yang berbudi tinggi layaknya seorang bangsawan</li>
    <li>Galuh Nafi Batari bermakna bidadari secantik intan mutiara yang bermanfaat bagi banyak orang</li>
    <li>Gamila Fauzia Latifah bermakna wanita cantik yang menang di kehidupannya karena mudah bergaul</li>
    <li>Gamila Shakayla Rimsha bermakna wanita cantik dan rupawan yang kulitnya selembut sutra</li>
    <li>Gamila Syana Asteria bermakna bintang cantik yang jatuh ke bumi membawa kasih Tuhan</li>
    <li>Gamila Zaida Sa’dah bermakna wanita cantik rupawan yang diuntungkan dengan kebahagiaan hati</li>
    <li>Ghadirah Nahlah Zuhailah bermakna gadis pandai dengan hati lembut yang bermanfaat dan membahagiakan orang-orang di sekitarnya</li>
    <li>Ghafira Mahira Alifha bermakna wanita cerdas berhati lembut, sabar, dan pemaaf</li>
    <li>Ghaida Najwa Kirana bermakna gadis lemah lembut yang diam-diam bercahaya secerah sinar mentari di waktu fajar</li>
    <li>Ghaisani Cahya Dewi bermakna perempuan dengan kecantikan seorang dewi yang bercahaya terang</li>
    <li>Ghaisani Nur Cahaya bermakna wanita dengan kecantikan yang bersinar berkat cahaya Tuhannya</li>
    <li>Ghaliyah Nazifa Zirwa bermakna wanita dengan hati murni berharga yang berharga dan memiliki semangat yang tinggi</li>
    <li>Ghania Farhin Annisa bermakna wanita indah nan cantik yang gembira</li>
    <li>Ghaniah Azifah Hamidah bermakna anak perempuan yang cantik dan terpuji yang selalu mendekatkan dirinya kepada Allah</li>
    <li>Ghanimah Ramiza Zaynah bermakna wanita sukses dan beruntung dengan kecantikan menawan yang sangat memikat</li>
    <li>Ghaniyyah Alzena Amira bermakna wanita yang tumbuh menjadi putri bangsawan dengan harta berlimpah</li>
    <li>Gharama Zahira Hanifa bermakna gadis penyayang yang bersinar terang karena setia pada kebenaran</li>
    <li>Ghassanah Nazirah Zuhdiyah bermakna wanita baik yang sangat paham agama dan luar biasa cantiknya</li>
    <li>Ghayda Rifdah Zakiyah bermakna gadis lembut dan murah hati yang penuh kasih dan kebaikan</li>
    <li>Ghaziyah Nurul Huda bermakna wanita yang gigih dalam mencapai tujuan, menjadi cahaya petunjuk bagi yang tersesat</li>
    <li>Ghazwa Nailah Zafirah bermakna wanita yang menang berkat kecerdikan dan kebijaksanaannya yang luar biasa</li>
    <li>Ghina Zahira Tasanee bermakna wanita cantik dengan kekayaan yang melimpah dari Tuhannya yang Maha Nyata</li>
    <li>Ghita Rashida Zafirah bermakna gadis pemberani yang siap menaklukkan dunia sesuai dengan petunjuk dari kebijaksanaan</li>
    <li>Ghitsaniyah Hafidhah Raisya bermakna wanita pelindung yang membawa berkah tiap kali ia terbangun</li>
    <li>Ghufayrah Rahmah Zabirah bermakna gadis kecil pemaaf yang membawa rahmat dan kebaikan di mana pun ia berada</li>
    <li>Ghulamah Lathifah Maqdis bermakna gadis sopan santun yang lembut hatinya seperti malaikat dari tanah suci</li>
    <li>Ghunaimah Zahira Halimah bermakna perempuan dengan kebahagiaan luar biasa yang membawa cahaya kedamaian</li>
    <li>Ghusniyah Marwa Salsabila bermakna wanita dengan kecantikan semurni batu mineral yang mengalir dari mata air surga</li>
    <li>Ghusnul Aisyah Qonitah bermakna perempuan cantik yang lemah lembut dan tekun dalam beribadah</li>
    <li>Ghusun Nabila Zakiyah bermakna pohon indah yang berbuah hal-hal mulia dan murni</li>
    <li>Gladis Shafa Reisha bermakna wanita bijaksana yang memiliki jubah serta pedang kecil di sisinya</li>
    <li>Gulwani Haibah Fityati bermakna anak perempuan muda yang berwibawa</li>
    <li>Gumala Oraida Harum bermakna wanita baik hati yang wangi dan cantik rupawan</li>
    <li>Habbaba Naifa Andyra bermakna rumah yang penuh kebaikan dan kejujuran memiliki daya tarik</li>
    <li>Habibah Khairiyah Izzati bermakna perempuan baik yang dikasihi dan mendapat kemuliaan</li>
    <li>Hadhira Bilqis Mallika bermakna ratu yang cerdas dalam memimpin bangsanya</li>
    <li>Hafsa Bilal Zaifa bermakna wanita pemenang dari surga yang merupakan pemberian Allah</li>
    <li>Halimah Zaybah Zafira bermakna wanita penyabar cantik, murah hati, dan sukses hidupnya</li>
    <li>Halwah Wanita Raniah bermakna seseorang perempuan berbakti yang manis dan memesona</li>
    <li>Hameda Asma Adha bermakna perempuan suci yang senantiasa bersyukur dan terlahir saat Idul Adha</li>
    <li>Hamida Aqilah Fiana bermakna wanita bersemangat yang selalu mensyukuri kecerdasan yang ia miliki</li>
    <li>Hana Kayla Maira bermakna perempuan cantik bermahkota bunga mekar yang cantik dan harum</li>
    <li>Hana Mia Ghazawi bermakna gadis suci yang cantik dan diliputi kebahagiaan sejati</li>
    <li>Haneefa Azura Sadya bermakna wanita mukmin sejati yang senantiasa tenang dan beruntung</li>
    <li>Hanfiah Hasuna Inarah bermakna seorang muslimah berwajah cantik dan bercahaya yang teguh pendirian</li>
    <li>Hanifa Kareem Almeera bermakna putri raja yang mulia memberi jalan terang</li>
    <li>Hanifah Raniah Kabira bermakna wanita anggun nan memesona yang rajin beribadah karena selalu ingat Tuhannya</li>
    <li>Hanifah Shabirah Hayat bermakna&nbsp;wanita yang diberi jalan terang dan penuh sabar dalam kehidupannya</li>
    <li>Hanni Rizqia Asheeqa bermakna perempuan yang bahagia sebab dicintai orang lain dan memiliki rezeki baik</li>
    <li>Hasna Ayda Karima bermakna anak yang cantik, murah hati, dan beruntung</li>
    <li>Hasna Balqis Jalilah bermakna ratu yang cantik dan mulia</li>
    <li>Hasna Sakhsiyah Amirah bermakna pemimpin yang kepribadiannya baik</li>
    <li>Hasuna Dajinah Hana bermakna anak perempuan cantik dan baik yang kelak akan dilimpahi kekayaan</li>
    <li>Hatim Anfa Aina bermakna bermakna cermin, harga diri, dan bertekad</li>
    <li>Haura Izra Adeeva bermakna wanita cantik seperti bintang yang lemah lembut</li>
    <li>Hayatun Butsaina Zahira bermakna wanita saliha&nbsp;yang hidup dengan bijaksana hingga ia dicintai Tuhannya</li>
    <li>Hayfa Naajia Arafah bermakna wanita mandiri dan mulia yang memiliki tubuh indah</li>
    <li>Hayva Arsyila Fadheela bermakna wanita rupawan yang memiliki jalan hidup tentram dengan sifat baiknya</li>
    <li>Hayva Sonya Kareina bermakna wanita terkasih yang diturunkan dengan bunga kebijaksanaan dari surga</li>
    <li>Hazna Basira Firzanah bermakna wanita berparas indah yang cerdik dan bijaksana dalam bertindak</li>
    <li>Hazna Ghaada Thara bermakna wanita cantik yang indah dan makmur hidupnya</li>
    <li>Helena Fasil Sabira bermakna wanita berkepribadian unik dan sabar yang memiliki cahaya spiritual</li>
    <li>Hibah Alliya Farzana bermakna gadis mulia pembawa keberuntungan yang merupakan hadiah dari Allah</li>
    <li>Hijazi Hifa Afia bermakna beruntung, emas, dan kebenaran</li>
    <li>Hilya Manha Maiza bermakna seorang anak pemberian Allah SWT yang cerdik, bijaksana dan cantik</li>
    <li>Humaira Sheza Adiba bermakna wanita yang saliha, cerdas dan berpipi merah</li>
    <li>Husna Kaureen Ifrah bermakna perempuan cantik yang membawa kebahagiaan</li>
    <li>Huwaida Hanny Nafia bermakna wanita anggung yang baik hati , lemah lembut, serta bermanfaat bagi banyak orang</li>
    <li>Ifa Sader Faiza bermakna gadis yang kuat menjaga imannya sehingga ia berjaya dalam&nbsp;hidupnya</li>
    <li>Iffah Astilah Rahmah bermakna perempuan dengan keturunan baik yang menjaga harga dirinya dan diliputi kasih sayang</li>
    <li>Iffah Kadziyah Hadanah bermakna wanita yang baik dan memelihara bunga yang harum baunya</li>
    <li>Ifrah Kanizah Laila bermakna gadis muda pembawa kebahagiaan yang dicintai</li>
    <li>Iftinan Syafira Athiya bermakna gadis yang lahir dalam anugerah dan berkah yang bersinar</li>
    <li>Iftinana Hanan Zalfa bermakna gadis memikat yang dihormati karena kasih sayangnya</li>
    <li>Iftitah Zahira Amani bermakna gadis yang bersinar sejak lahir dan membawa kedamaian serta harapan</li>
    <li>Ihza Afaf Shakiela bermakna anak yang cantik, berbudi luhur, dan juga beruntung</li>
    <li>Ihza Naira Shakina bermakna gadis cantik yang disinari keberuntungan</li>
    <li>Ijliya Humaira Fathia bermakna wanita yang bercahaya karena dikaruniai kebahagiaan oleh Allah</li>
    <li>Ilhami Qaisara Afifa bermakna wanita mulia yang menjadi inspirasi karena kelembutan hati dan akhlak baiknya</li>
    <li>Ilmira Qonita Hanifah bermakna wanita berilmu dengan iman yang bertumpu pada kebenaran</li>
    <li>Imani Salwa Nazirah bermakna perempuan taat dan cantik yang membawa kebahagiaan sejati</li>
    <li>Imanina Yasmin Aulia bermakna gadis dengan keyakinan yang tahan lama seperti bunga yang terpilih karena keharumannya</li>
    <li>Inaayat Hafsa Kalila bermakna macan kecil yang disayangi karena kepeduliannya terhadap satu sama lain</li>
    <li>Inara Badzlin Shaqueena bermakna seorang anak perempuan yang berpembawaan tenang, murah hati, dan berkarisma</li>
    <li>Inara Rizqiana Alesha bermakna wanita yang dilindungi cahaya Allah serta dilimpahi rezeki oleh-Nya</li>
    <li>Inaya Kynna Amira bermakna pemimpin wanita yang senang membantu dan melindungi orang di sekitarnya</li>
    <li>Inayah Freya Jawaria bermakna ratu penolong dan penyebar kebahagiaan</li>
    <li>Inayah Rahima Athifah bermakna gadis yang sangat perhatian perhatian dengan perasaan Tuhannya yang Maha Penyayang</li>
    <li>Indah Sufia Na'imah bermakna gadis cantik yang membawa kebahagiaan dan keberkahan</li>
    <li>Insyiqa Qonita Azima bermakna wanita yang dimuliakan karena khusyuk dan indah dalam bersikap</li>
    <li>Intisar Karima Fawziya bermakna gadis yang sukses dan berhasil, tetapi tetap murah hati</li>
    <li>Ira Qasim Aayza bermakna gadis penuh kebaikan yang merupakan pemberian Allah kepada bumi</li>
    <li>Irdina Jauzah Kalmani bermakna anak perempuan yang baik perkataannya, membuatnya dihormati banyak orang</li>
    <li>Irsa Arfiani Marwa bermakna gadis pembawa kebaikan abadi dan kebahagiaan yang menginspirasi</li>
    <li>Irsalina Huwaida Jahirah bermakna anak perempuan berparas rupawan dan berhati lemah lembut</li>
    <li>Iskandar Ghaaliya Aly bermakna rumah mulia yang bercahaya dan mengeluarkan wewangian</li>
    <li>Ismah Zara Adiba bermakna wanita berbudi luhur dengan kesucian yang indah</li>
    <li>Ismat Fyha Iyana bermakna wanita pengasih yang namanya harum dan penuh kemurnian</li>
    <li>Ismat Zia Saifa bermakna cahaya yang bersinar dengan penuh kemurnian</li>
    <li>Ismi Nur Asyifa bermakna anak perempuan yang membawa cahaya kesembuhan</li>
    <li>Ismira Fadila Syafia bermakna wanita mulia yang senantiasa hidup dalam keindahan dan keberkahan</li>
    <li>Izzati Akilah Aimuni bermakna anak perempuan yang mulia dan pintar yang menjadi anugerah terbesar di hidupnya</li>
    <li>Izzatun Salsabila Aqsa bermakna gadis dengan kehormatan yang jernih seperti air yang mengalir dalam kesucian</li>
    <li>Jafreena Nafisah Zainab bermakna wanita cantik dengan kelembutan yang memuliakannya sebagai berkah berharga dari Tuhannya</li>
    <li>Jahanara Quratul'ain Syifa bermakna gadis secantik bunga indah yang membawa kesembuhan dari Allah untuk penyakit hati banyak orang</li>
    <li>Jaharah Ghadish Anaqah bermakna anak perempuan yang cantik dan enak dipandang di tengah keramaian</li>
    <li>Jaleela Asyifa Zuhairah bermakna wanita mulia yang membawa cahaya kesembuhan di malam hari berkat karunia dari Allah</li>
    <li>Jalilah Wijdaniah Kamilah bermakna pencapaian yang sempurna dan mulia</li>
    <li>Jalwa Husna Humaira bermakna anak rupawan berpipi merah yang penuh kebaikan</li>
    <li>Jalwa Nur Ilmira bermakna putri yang rupawan dan bercahaya</li>
    <li>Jameela Shanum Simiya bermakna wanita yang diberkati Allah dengan kecantikan berharga</li>
    <li>Jamila Farhana Malika bermakna ratu cantik yang membawa kebahagiaan</li>
    <li>Jamila Fethna Alfathunisa bermakna gadis lembut nan cantik yang menarik hati</li>
    <li>Jamila Hanum Alifa bermakna anak perempuan yang lahir pertama yang cantik dan lembut</li>
    <li>Jamila Zoysa Inaya bermakna karunia Allah yang cantik dan unik</li>
    <li>Janan Rahma Hanifa bermakna wanita bijaksana dan penyayang yang hidup dengan penuh keimanan</li>
    <li>Janeeta Isytihar Karimah bermakna gadis terkenal dan mulia yang merupakan hadiah terindah&nbsp;dari Tuhan</li>
    <li>Jannah Hasna Atiya bermakna hadiah yang indah dari surga</li>
    <li>Jannah Nurul Abidah bermakna perempuan ahli ibadah yang selalu bercahaya dan memancarkan keindahan surga</li>
    <li>Jasmin Jannah Hazna bermakna bunga di taman surga yang indah</li>
    <li>Jasmine Nur Annisa bermakna wanita dengan sifat seharum bunga melati yang tumbuh di bawah cahaya baik</li>
    <li>Jasmira Laila Najwa bermakna gadis yang berkilau seperti perhiasan di malam hari yang membawa pesan rahasia yang indah</li>
    <li>Jauharah Ghaliya Shabur bermakna perempuan anggun dengan kesabaran sekuat batu permata yang paling mahal</li>
    <li>Jauzanah Zahida Mufidah bermakna wanita yang tekun beribadah dan memberikan manfaat bagi orang lain</li>
    <li>Jawahir Fathimah Zaynab bermakna gadis terhormat dan lemah lembut yang dikaruniai dengan kecerdasan berharga dari Tuhan</li>
    <li>Jawahir Zara Aaiza bermakna putri cantik yang tubuhnya tertutupi banyak perhiasan</li>
    <li>Jazima Kaisah Huraiyah bermakna anak perempuan bermata elok yang tegas serta bijaksana dalam bertindak</li>
    <li>Jaziri Aria Zahra bermakna wanita dengan wajah berseri-seri yang tenang hatinya dan penuh percaya diri</li>
    <li>Jelita Fauqiyya Putri bermakna perempuan yang sangat cantik dan mengagumkan</li>
    <li>Jihanah Adibah Najila bermakna wanita bijaksana yang membawa kebaikan murni dalam tiap ucapannya</li>
    <li>Jinan Husna Haifa bermakna gadis penghuni kebun surga yang cantik dan bertubuh indah</li>
    <li>Jinan Maira Nafeesa bermakna cahaya surga yang berharga</li>
    <li>Johara Aliza Afifah bermakna gadis dengan keceriaan yang berharga seperti permata, serta selalu menjaga kesucian dirinya</li>
    <li>Jowaida Sakinah Hafsa bermakna wanita berhati lembut yang selalu mendamaikan orang-orang di sekitarnya</li>
    <li>Juhara Shakira Aziza bermakna gadis pembawa kebahagiaan berkalung perhiasan dari Allah yang bersinar</li>
    <li>Jumlatul Zulfa Arifah bermakna wanita berhati lembut dan tulus yang memiliki pemahaman agama setinggi langit</li>
    <li>Junaidah Nisrina Ramlah bermakna wanita yang berdiri teguh di jalan kebenaran dan mendapatkan cinta kasih Allah</li>
    <li>Juthamah Zafira Naila bermakna wanita pemberani yang membawa kemenangan serta kebahagiaan</li>
</ol>
<ol>
    <li>Kadira Nura Zaina bermakna perempuan cantik dengan cahaya yang bersinar kuat</li>
    <li>Kaifiya Humaira Arisha bermakna anak perempuan mulia yang riang gembira dengan pipi kemerahan</li>
    <li>Kaina Noor Aina bermakna pemimpin pilihan Allah yang merupakan cerminan hal-hal baik</li>
    <li>Kalilah Suhana Adha bermakna putri tercinta yang cantik dan lahir di Hari Raya Idul Adha</li>
    <li>Kamala Rahim Alifah bermakna gadis yang disempurnakan Tuhannya dengan keramahan dan kasih sayang di hatinya</li>
    <li>Kamilah Namiera Arsyila bermakna perempuan yang bahagia dan hidupnya sempurna secara keseluruhan</li>
    <li>Kamilah Nur Ainunnisa bermakna mata wanita yang sempurna dan bercahaya</li>
    <li>Kanaya Khoiruna Azmi bermakna seorang perempuan dengan kebaikan dab keteguhan hati yang hidup dengan tenteram</li>
    <li>Kania Zaida Azmi bermakna gadis muda dengan kelebihan yang berupa hati yang teguh</li>
    <li>Kanzia Taleetha Ufairah bermakna seorang anak perempuan yang dapat menjadi seorang pejuang yang berani</li>
    <li>Karima Jahidah Mufida bermakna anak perempuan mulia nan bermanfaat yang gemar menolong orang yang lemah</li>
    <li>Kasyfa Khalishah Manshurah bermakna gadis yang selalu ditolong dengan tulus ketika dalam kesulitan agar hidupnya dimudahkan</li>
    <li>Kayla Akasma Azqila bermakna anak perempuan yang bermahkotakan mawar putih nan suci</li>
    <li>Kayla Shakeela Alnaira bermakna anak perempuan cantik rupawan seperti mahkota yang gemerlap</li>
    <li>Kaysha Aziza Inayaat bermakna perempuan yang hidup bahagia dan dimuliakan karena kepeduliannya</li>
    <li>Kaysha Paramitha Adira bermakna perempuan dengan kehidupan bahagia yang gigih dalam menebar kebaikan</li>
    <li>Keisha Zahra Anindita bermakna seorang putri yang terlahir sempurna seperti putri Rasulullah</li>
    <li>Khaila Azkiya Annisa bermakna wanita saliha yang memakai mahkota</li>
    <li>Khaira Fazila Farhana bermakna anak mengesankan yang membawa kebaikan dan kebahagiaan</li>
    <li>Khaira Nisa Faida bermakna wanita yang baik dan beruntung</li>
    <li>Khairina Gadis Juwita bermakna anak perempuan yang penuh cinta dan kebaikan</li>
    <li>Khairina Imanina Haziqah bermakna anak perempuan yang cerdik dan kuat menjaga imannya</li>
    <li>Khairunnisa Afreen Islami bermakna perempuan yang baik, cantik, dan selalu diberi keselamatan</li>
    <li>Khalida Dayana Damia bermakna perempuan berjiwa kuat yang akan dipenuhi oleh keberkahan selama-lamanya</li>
    <li>Khaliesah Imarah Mahrusah bermakna anak perempuan yang terlindungi dari kesusahan dan jujur dalam ucapannya</li>
    <li>Khalifa Naruna Fahhama bermakna pemimpin umat manusia yang sangat pintar</li>
    <li>Khalishah Fikratuha Sahira bermakna perempuan yang dapat memikat hati orang lain dengan pemikirannya yang murni</li>
    <li>Khansa Ulya Shiddiq bermakna seorang anak perempuan yang baik dan jujur serta tinggi derajatnya</li>
    <li>Khanza Adzkiya Fakhirah bermakna wanita baik dan cerdas yang menjadi kebanggaan</li>
    <li>Khanza Karunia Nimah bermakna wanita baik pemberian tuhan yang diberkati</li>
    <li>Khayira Annisa Fadhillah bermakna gadis saliha&nbsp;yang cantik dan mendapat kemuliaan</li>
    <li>Khayla Almira Maritza bermakna putri cantik yang memperoleh keberkahan dari Allah</li>
    <li>Khayyirah Dinar Fatina bermakna anak perempuan yang berharga karena memiliki hati yang baik dan bijaksana</li>
    <li>Kiraman Hazirah Mahdiyyah bermakna anak perempuan yang dimuliakan dan mendapatkan hidayah terbaik dari Allah</li>
    <li>Kurnia Mahia Chayria bermakna berkah kehidupan dan kebaikan</li>
    <li>Labiba Aqilla Dhabitah bermakna gadis bijak dan pintar yang kuat ingatannya</li>
    <li>Labiba Azka Adilah bermakna perempuan cerdik yang adil dalam bersikap karena jiwanya yang suci</li>
    <li>Laela Zahirah Kamilah bermakna cahaya yang bersinar sempurna di malam yang gelap</li>
    <li>Laibah Aniq Afsana bermakna wanita yang dikenal cantik, lucu, dan mungil</li>
    <li>Laila Balqis Atikah bermakna ratu pemurah yang dicintai rakyatnya</li>
    <li>Laila Rukhsar Zuhaira bermakna gadis secantik bunga yang berpenampilan anggun memesona</li>
    <li>Laila Zea Shadman bermakna malam yang bersinar dan bahagia</li>
    <li>Lailah Hajidah Athalla bermakna wanita yang dikaruniai Allah karena bangun untuk melaksanakan sholat malam</li>
    <li>Laili Hasna Athar bermakna wanita cantik bagaikan mutiara murni</li>
    <li>Laiqa Shatierra Tamurah bermakna wanita yang indah dan baik layaknya bunga</li>
    <li>Laiqa Suniyyah Syakayla bermakna wanita cantik dan indah bersinar</li>
    <li>Laitha Thara Widad bermakna wanita dengan cahaya kebaikan sehebat petir yang bergemuruh dengan kuat</li>
    <li>Lakeisha Ayu Farannisa bermakna perempuan cantik yang hidup dengan penuh kebahagiaan dan kesejahteraan</li>
    <li>Lami’ah Azkiya Majdiyah bermakna wanita saliha&nbsp;yang terhormat dan cemerlang</li>
    <li>Lamia Basma Najwa bermakna wanita dengan senyuman berseri dan penuh kasih sayang yang mampu menerangi kegelapan</li>
    <li>Lamira Rahmah Athifa bermakna putri mulia yang penuh kasih dan lemah lembut</li>
    <li>Lamisah Naimah Zuwaina bermakna gadis lembut dan menyenangkan yang membawa kebahagiaan pada orang-orang di sekelilingnya</li>
    <li>Lamya Qudsia Zainab bermakna wanita terhormat yang mampu menghapus kegelapan dengan hatinya yang suci</li>
    <li>Lamyah Salihah Adha bermakna wanita menyenangkan dan berbibir gelap nan indah yang lahir di Hari Raya Idul Adha</li>
    <li>Lateefa Ayda Naira bermakna gadis bercahaya yang ramah dan membawa keberuntungan</li>
    <li>Latifah Zahra Aisha bermakna perempuan cantik berhati baik nan lembut yang selalu merasa riang gembira</li>
    <li>Layan Nuha Hadiya bermakna wanita lemah lembut yang berjalan di atas jalan bercahaya berdasarkan petunjuk Tuhannya</li>
    <li>Layyina Afiyah Fuadah bermakna perempuan lembut yang berhati nurani tinggi dan sehat jasmani</li>
    <li>Layyina Maimun Lakeisha bermakna anak perempuan berhati lemah lembut yang diberkati dengan kehidupan sejahtera</li>
    <li>Lidiya Maisarah Marjani bermakna anak perempuan dengan kekayaan yang sangat berharga bagi dirinya</li>
    <li>Lina Salihah Zaynab bermakna gadis cantik yang berperilaku saleh dan bijaksana</li>
    <li>Liya Syna Bakir bermakna putri cantik yang lahir saat waktu fajar</li>
    <li>Liza Sifa Ghazawwi bermakna gadis yang diberkati Allah dengan dilahirkan di tempat yang suci</li>
    <li>Lu'luah Yusra Zulaikha bermakna wanita pembawa kemakmuran yang bersinar seperti bintang dari mutiara</li>
    <li>Lubanah Hafshah Dzakiyyah bermakna wanita berhati murni yang berjuang untuk menebar kebaikan</li>
    <li>Lubna Noor Hania bermakna perempuan cantik dengan kulit putih bercahaya yang makmur dan bahagia</li>
    <li>Lujain Hafsa Rania bermakna wanita memesona yang melindungi dengan penuh keanggunan</li>
    <li>Lulu Hajar Hayiyyah bermakna gadis rendah hati yang kehadirannya membawa ketenangan</li>
    <li>Luluah Nafisah Zahra bermakna gadis yang bercahaya dengan penuh kelembutan seperti mawar cantik yang berharga</li>
    <li>Luthfia Alia Dewi bermakna perempuan berhati lemah lembut yang berasal dari tempat yang menguatkannya</li>
    <li>Ma'muunah Aaliya Aisyah bermakna wanita cerdas yang berumur panjang dan dapat dipercaya</li>
    <li>Mafaza Amara Firdaus bermakna wanita cantik yang selamat hingga dapat menuju surga firdaus</li>
    <li>Mahbuah Almira Azzaida bermakna pemimpin wanita yang dicintai karena kesederhanaannya</li>
    <li>Mahbuah Ariqah Al-Hasanah bermakna wanita yang baik budi, mulia, dan dicintai</li>
    <li>Mahdiyyah Gauthiah Amany bermakna wanita yang berkeinginan besar untuk mendapat hidayah dari Allah</li>
    <li>Mahia Anam Hariri bermakna gadis yang diberkati dengan cinta selembut kain sutra</li>
    <li>Mahira Shafa Lathifah bermakna perempuan lemah lembut yang pandai menyucikan hatinya agar tetap bersih</li>
    <li>Mahreen Syahla Ainayya bermakna perempuan yang memiliki mata indah yang kebiru-biruan, terang, dan cantik seperti matahari</li>
    <li>Mahreen Zubi Azahra bermakna perempuan yang sangat cerdas dan menyenangkan yang kelak bersinar terang</li>
    <li>Maimunah Shalihah Zoraiz bermakna wanita alim yang diberkati dengan cahaya kebaikan yang ia tebarkan</li>
    <li>Maira Salwa Rafifa bermakna gadis pembawa cahaya kehangatan yang menyenangkan dan semanis madu</li>
    <li>Maira Zoya Alisha bermakna anak perempuan baik hati yang mencintai hidupnya dan dilindungi oleh Allah SWT</li>
    <li>Maisurah Aina Muslimah bermakna perempuan muslimah yang dilimpahkan dengan kebahagiaan selamanya</li>
    <li>Majdah Arumi Faidah bermakna perempuan pintar yang terlahir dari keturunan orang-orang bermanfaat</li>
    <li>Maleeha Shazfa Aghnia bermakna gadis cantik yang kelak akan sukses dan kaya</li>
    <li>Malika Anya Hafsa bermakna ratu cantik bermata bulat yang indah</li>
    <li>Mariyah Fithratun Nufuus bermakna perempuan yang memiliki jiwa yang suci sejak lahir</li>
    <li>Marwa Fatih Aqilah bermakna kemenangan berakal berhati-hati dalam memikirkan</li>
    <li>Maryam Khalisa Faiqah bermakna perempuan yang mulia dan terhormat serta terbebas dari dosa</li>
    <li>Maula Zahratul Adhwa bermakna perempuan yang menerangi sekaligus bunga kehidupan Allah</li>
    <li>Mawaddah Adiva Savina bermakna anak cantik yang baik hati dengan hati lembut dan berlimpah kasih sayang</li>
    <li>Meha Aeza Nahdi bermakna taat, cerdas, dan kuat</li>
    <li>Mersiha Ardani Mehrunisa bermakna wanita cantik yang paling cantik serta suci</li>
    <li>Mia Ghazawwi Zoha bermakna pejuang wanita dengan cahaya kecantikan yang bersinar terang</li>
    <li>Misba Aleena Benasir bermakna gadis anggun nan lembut yang dimuliakan</li>
    <li>Misla Nabila Yaqutillahi bermakna perempuan dengan kecantikan wajah dan hati seperti permata dari Tuhan</li>
    <li>Mona Saba Azkadina bermakna gadis pembawa kedamaian yang menyejukkan hatinya karena senantiasa taat pada ajaran agamanya</li>
    <li>Mufidah Nurul Azmi bermakna seorang perempuan yang berguna dengan keteguhan hati yang selalu dinaungi cahaya</li>
    <li>Mulki Aghni Afiya bermakna wanita yang berkecukupan dan menjadi pemimpin yang pemaaf</li>
    <li>Munawwarah Afra Ashimah bermakna perempuan cantik yang pandai menjaga diri dan mendapat petunjuk dari Allah SWT</li>
    <li>Musfirah Nura Rahima bermakna perempuan berwajah cerah yang baik hati dan penyayang</li>
    <li>Myesha Adeva Afshen bermakna perempuan yang dikarunia kehidupan menyenangkan dan bersinar seperti bintang di langit</li>
    <li>Myesha Athaya Rizqiana bermakna anugerah dari Allah yang hidupnya membawa rezeki melimpah serta diberi kemudahan</li>
    <li>Myisha Wadd Mahya bermakna wanita tersayang yang bersinar</li>
    <li>Myza Asghar Ayra bermakna wanita anggun dengan kehormatan yang bersinar</li>
    <li>Na’imah Khansa Jaidah bermakna mendapat nikmat memiliki hidung mancur dan leher panjang</li>
    <li>Na’imah Zahaan Fauzia bermakna anak yang berwawasan luar biasa, membawa ketenangan, dan keberuntungan</li>
    <li>Nabilah Masyita Sakhi bermakna wanita suci yang mulia dan murah hati</li>
    <li>Nabilah Reidah Zeina bermakna pemimpin perempuan yang dimuliakan pengikutnya</li>
    <li>Nada Ameena Shabira bermakna gadis setia dan penyabar yang kehadirannya menenangkan seperti embun di pagi hari</li>
    <li>Nada Kaina Farida bermakna perempuan berharga dengan sifat murah hati dan pemaaf</li>
    <li>Nadia Shanika Haura bermakna perempuan yang cantik, baik, dan dermawan</li>
    <li>Nadirah Faidah Hasna bermakna perempuan yang bermanfaat dan cantik yang jarang ditemukan</li>
    <li>Nafisa Rasyida Aishah bermakna wanita dengan kecerdasan yang sangat berharga dan terjaga lama</li>
    <li>Nafisah Hilya Afifah bermakna perempuan yang berharga dan memiliki kemuliaan yang tinggi</li>
    <li>Nahla Farhat Fiana bermakna perempuan&nbsp;setenang air dengan kehidupan yang penuh keagungan, kegembiraan, dan rasa semangat</li>
    <li>Naifah Annisa Asma bermakna wanita yang memiliki kedudukan yang tinggi dan mulia</li>
    <li>Naila Adzkiya Taleetha bermakna wanita muda yang sukses dan cerdas</li>
    <li>Nailah Raihanah Nurjannah bermakna wanita yang berjiwa baik dan suka memberi mendapatkan cahaya surga</li>
    <li>Naira Farah Aiza bermakna anak gadis terhormat dengan kecantikan yang bersinar</li>
    <li>Najla Jameelah Ashiya bermakna anak cantik bermata lebar yang diberi keberuntungan</li>
    <li>Najwa Alila Arsyila bermakna perempuan berjiwa kuat yang menjaga rahasia dan damai hidupnya</li>
    <li>Nalani Aneira Hazna bermakna wanita cantik berkulit putih seindah surga</li>
    <li>Nasira Naila Dzulhijjah bermakna gadis yang dilimpahi kemenangan dan kesuksesan karena terlahir di bulan Zulhijah</li>
    <li>Naura Ayu Humaira bermakna perempuan dengan kecantikan sebuah bunga yang berwarna kemerah-merahan</li>
    <li>Nayyara Kayla Azga bermakna perempuan bermahkota indah yang memancarkan sinar</li>
    <li>Nazua Keyla Hadara bermakna wanita cantik bermahkota yang memiliki semangat tinggi</li>
    <li>Nikeisha Shofiyyah Ramadniya bermakna wanita yang jernih dan indah</li>
    <li>Nirbita Syaikah Qutratu’ain bermakna pemimpin yang tak pernah takut dan enak dipandang</li>
    <li>Nisa Ameena Lathifah bermakna perempuan cantik berhati lembut yang setia</li>
    <li>Nisrina Fitri Faiha bermakna bunga mawar putih yang suci dan banyak kelebihannya</li>
    <li>Nitasha Asma Qamela bermakna keberkahan yang mulia dan sempurna</li>
    <li>Nuha Arumi Sabrina bermakna wanita yang akan menjadi keturunan cerdas dan cantik seperti bidadari</li>
    <li>Numa Anandita Adriani bermakna gadis muda yang kuat dan menyenangkan</li>
    <li>Nur Falah Rihab bermakna gadis pembawa cahaya kemenangan yang besar</li>
    <li>Nur Falisha Laila bermakna cahaya kebaikan di malam hari</li>
    <li>Nur Maisara Wahyuni bermakna cahaya karunia dan titipan yang membawa ketenangan dan kegembiraan</li>
    <li>Nur Rezki Sakira bermakna pancaran cahaya yang terdapat rezeki dari Allah SWT dan bersyukur</li>
    <li>Nyra Faez Aiza bermakna gadis seindah mawar yang dimuliakan karena kesetiaannya</li>
    <li>Nyza Nuha Khalid bermakna wanita yang dianugerahi dengan kebijaksanaan abadi</li>
    <li>Obaida Rahima Yasira bermakna perempuan penyayang dengan keberanian yang luar biasa</li>
    <li>Odeya Safiyya Tazkia bermakna perempuan dengan jiwa yang murni dan suci</li>
    <li>Ojala Hadiya Qamariya bermakna wanita yang menjadi anugerah bagi banyak orang seperti rahmat dari cahaya bulan</li>
    <li>Olena Maryam Zarah bermakna perempuan tercinta dengan hati yang suci dan kecerdasan yang bersinar</li>
    <li>Omaira Adiva Sabiya bermakna anak baik yang terlahir di pagi hari bersama bintang-bintang kemakmuran</li>
    <li>Omara Faeqa Amanda bermakna perempuan yang disukai karena menjaga keanggunan dan kecantikannya</li>
    <li>Omaya Calista Yasmin bermakna perempuan yang memiliki keanggunan dan ketenangan seperti bunga melati</li>
    <li>Omayma Kausar Nazira bermakna perempuan yang hidupnya penuh berkah dan menjadi teladan bagi orang lain</li>
    <li>Omeira Tanweer Qudsia bermakna perempuan pembawa cahaya yang menerangi tiap sudut bumi</li>
    <li>Omia Nadira Salma bermakna perempuan yang langka dan indah seperti mutiara</li>
    <li>Omnia Fathima Laila bermakna wanita yang menjadi sumber cahaya keberuntungan seperti sinar rembulan</li>
    <li>Onaiza Fawziyah Rania bermakna ratu yang memperoleh kemenangan dan keindahan mutlak</li>
    <li>Onisa Marwa Nadhira bermakna wanita yang berkilau seperti permata yang langka</li>
    <li>Oraib Dania Zafira bermakna perempuan cerdas dan berani yang bersinar secerah permata murni</li>
    <li>Orin Emaan Hadiya bermakna perempuan yang dipercayai untuk menjadi petunjuk bagi orang lain</li>
    <li>Orina Hania Samira bermakna wanita anggun yang tetap bahagia meski berada di tengah malam yang gelap</li>
    <li>Orlina Alishba Suraiya bermakna gadis secantik bintang yang berkilau dalam cahaya keemasan</li>
    <li>Oruba Wafa Zulfa bermakna perempuan setia dengan hati lemah lembut yang indah seperti bunga</li>
    <li>Orwa Saadiya Zayna bermakna gadis dengan keindahan mengagumkan yang membawa kebahagiaan</li>
    <li>Osha Rayan Vania bermakna perempuan dengan kecerdasan tajam yang menjadi sumber kebahagiaan</li>
    <li>Oshaira Kiaria Amrisha bermakna wanita yang sangat beruntung karena dilimpahi rezeki sebenar-benarnya</li>
    <li>Oshrat Zakiya Umara bermakna perempuan mulia dengan kebaikan batin yang kelak membuatnya menjadi pemimpin</li>
    <li>Osima Nusrat Zara bermakna perempuan menawan yang kelak menjadi pertolongan indah bagi orang lain</li>
    <li>Osma Faiqa Jamila bermakna perempuan dengan kecantikan yang luar biasa dan menjadi teladan bagi wanita lain</li>
    <li>Osraa Zaina Yusra bermakna perempuan yang diberkati Allah dengan kecantikan yang bersinar</li>
    <li>Osrah Fatima Sabiha bermakna wanita yang dihormati karena memiliki kecerdasan di atas rata-rata</li>
    <li>Otaiba Jamila Nadira bermakna perempuan dengan kecantikan yang langka dan istimewa</li>
    <li>Oula Fadila Rahma bermakna perempuan yang dimuliakan karena mampu bersikap adil namun tetap penuh belas kasihan</li>
    <li>Ova Ghalia Khalida bermakna perempuan dengan kecantikan abadi yang penuh keagungan</li>
    <li>Owaisa Karima Rasha bermakna perempuan baik hati yang diberkati dengan kemuliaan</li>
    <li>Oya Latifa Safiya bermakna gadis dengan hati yang terikat pada kelembutan dan kesucian</li>
    <li>Oyuna Yara Widad bermakna perempuan mulia yang dilimpahi rasa cinta yang membuat hidup terasa indah</li>
    <li>Oza Imaan Mahira bermakna perempuan mulia dengan kepercayaan yang kuat</li>
    <li>Ozaiba Madiha Nayla bermakna perempuan secantik bunga mawar yang senantiasa dipuji-puji</li>
    <li>Ozara Hafsa Laila bermakna perempuan seindah langit malah yang dilindungi oleh Tuhan</li>
</ol>
<ol>
    <li>Pakeezah Salsabila Zahira bermakna gadis berhati suci yang berasal dari mata air yang bersinar terang</li>
    <li>Paquita Rukayya Aisyah bermakna perempuan cantik nan anggun yang setia pada agamanya</li>
    <li>Paradisa Nazanin Laila bermakna wanita seindah kebun dengan mata air yang mengalir dengan pesona di langit malam</li>
    <li>Parandis Orkidea Rasha bermakna bunga yang harum dengan kemuliaan dan keceriaan yang memesona</li>
    <li>Parandisa Gulzar Umayma bermakna gadis berhati lembut dengan kecantikan seperti bunga yang indah dan melimpah</li>
    <li>Parandisa Mariam Rania bidadari berparas indah dengan kesucian dan keanggunan yang dihormati</li>
    <li>Pari Zara Alima bermakna wanita peri berwajah indah dengan kecerdasan dan kebijaksanaan yang luar biasa</li>
    <li>Parichehr Fariha Zainab bermakna wanita tercantik yang membawa cahaya kegembiraan paling terang</li>
    <li>Parichehr Samira Dian bermakna wanita dengan kecantikan dari surga yang selalu ramah dan bersahabat</li>
    <li>Parinaz Khadija Yasmina bermakna wanita dengan ketulusan hati selangka bunga kemuliaan yang terpuji</li>
    <li>Parinda Marwa Ayesha bermakna gadis yang merasa bebas di hidupnya seperti burung dengan sayap yang berharga</li>
    <li>Parisa Lulu Amira bermakna bunga indah dengan kelembutan dan keanggunan yang memesona</li>
    <li>Parisa Zivana Ramiah bermakna pemimpin wanita secantik peri yang selalu mengagungkan nama Tuhannya</li>
    <li>Parivash Naila Yasmine bermakna wanita memesona dengan keindahan yang tak tergantikan seperti bunga yang semerbak</li>
    <li>Pariya Roshanak Yasmin bermakna gadis yang tumbuh di bawah sinar mentari hingga menjadi bunga yang harum</li>
    <li>Parizad Niloufar Dalia bermakna wanita sesuci bunga teratai yang hidupnya ditakdirkan datang dan berakhir di surga</li>
    <li>Parnian Najwa Fatima bermakna wanita artistik yang menjaga selalu perasaan orang lain lewat tutur katanya</li>
    <li>Parvaneh Dina Zahra bermakna wanita dengan kecantikan yang diakui banyak orang dan bersinar seterang bintang di langit</li>
    <li>Parvin Marjan Khadijah bermakna wanita dengan kehormatan yang bersinar sehebat paduan bintang dan butir-butir mutiara</li>
    <li>Parvina Jamila Warda bermakna wanita yang mampu menjaga kecantikannya agar tetap secerah bintang</li>
    <li>Parvina Zara Laila bermakna putri anggun yang bersinar seterang bintang di malam hari</li>
    <li>Parwina Halima Zainab bermakna perempuan dengan kelembutan hati yang wangi dan bersinar secerah bintang</li>
    <li>Parya Esra Nisrin bermakna bidadari yang dihargai dengan keindahan dan keceriaan yang bersinar</li>
    <li>Parya Hana Samira bermakna bidadari cantik yang hangat tutur katanya karena hatinya yang senantiasa bahagia</li>
    <li>Pasha Azka Farhana bermakna gadis saleha yang diliputi kebahagiaan seluas lautan</li>
    <li>Pasha Roshanara Amina bermakna wanita dengan kepercayaan yang mampu menyinari bagian terdalam lautan</li>
    <li>Payvand Suhayla Jannah bermakna gadis pembawa kebahagiaan berlimpah dari surga yang menjadi perantara untuk keindahan yang tak terlukiskan</li>
    <li>Pernia Farzaneh Lina bermakna wanita lembah lembut dengan pengetahuan tentang seni yang luas</li>
    <li>Pernia Hadya Samayra bermakna pemimpin wanita dengan keahlian seni yang memikat</li>
    <li>Pilara Noura Zahira bermakna tiang kokoh yang memberikan cahaya dan kecerahan di sekitarnya</li>
    <li>Piroozeh Amina Kandera bermakna wanita seberani pemanah yang berani serta jujur dan amanah</li>
    <li>Piroozeh Yasmin Zuleika bermakna wanita cantik yang dicintai karena bakat memanahnya yang berharga</li>
    <li>Purya Naseem Asma bermakna wanita selembut desiran angin terbaik yang bisa mengisi kekosongan hati orang lain</li>
    <li>Puspa Sakina Faridah bermakna bunga yang membawa ketenangan dan keadilan dalam segala hal</li>
    <li>Putri Azarine Afifah nama yang bermakna perempuan yang agung dan penuh welas asih</li>
    <li>Qadira Dwi Fauzia bermakna anak kedua yang selalu mampu menemukan kesuksesan dalam hidup</li>
    <li>Qadriyyah Nur Aini bermakna cahaya mataku yang memiliki banyak kemampuan</li>
    <li>Qaila Ameera Annaila bermakna gadis yang selalu gembira dan akan menjadi pemimpin berkat kepandaiannya dalam berbicara</li>
    <li>Qailah Shezan Mahasin bermakna perempuan berparas cantik dengan tutur kata yang selalu menarik hati</li>
    <li>Qaisah Nabilah Kanizah nama yang bermakna kekuatan, mulia, dan muda</li>
    <li>Qaisara Ilhami Syifa bermakna pemimpin wanita yang membawa inspirasi dan penyembuhan bagi banyak orang sejak muda</li>
    <li>Qaisara Najmiyah Syakira bermakna pemimpin wanita yang bercahaya seperti bintang dan penuh rasa syukur sejak muda</li>
    <li>Qaisya Naila Amalina bermakna wanita pembawa keselamatan yang senantiasa berbuat amal yang jelas-jelas baik</li>
    <li>Qamarina Azzahra Husniah bermakna gadis pembawa kebaikan dengan kecantikan yang bersinar seterang bulan purnama</li>
    <li>Qamarina Warisa Azalia bermakna wanita yang mewariskan kecemerlangan dari cahaya bulan</li>
    <li>Qamila Rashida Haura bermakna wanita sempurna yang cerdas dan selalu berseri wajahnya</li>
    <li>Qamra Awanta Azalea bermakna cahaya rembulan yang membawa kebebasan dan kemuliaan</li>
    <li>Qaniah Salwa Zahira bermakna wanita yang puas dengan rezeki Allah yang indah</li>
    <li>Qanita Layana Najwa bermakna hamba Allah yang cantik dan percaya diri</li>
    <li>Qashrina Falahiyah Zuhairah bermakna wanita bangsawan yang teguh bersikap bijaksana dengan wajah bercahaya yang menyerupai&nbsp;malaikat</li>
    <li>Qasidah Hafshah Balqis bermakna ratu terhormat yang namanya akan terjaga dalam kisah turun temurun</li>
    <li>Qasima Rizqia Inaya bermakna perempuan cantik pembawa rezeki yang merupakan karunia dari Allah</li>
    <li>Qatrunnada Insyirah Ghaida bermakna hujan lembut yang membawa kenyamanan dan kebahagiaan</li>
    <li>Qauliyah Safira Ufairah bermakna wanita yang selalu memiliki pendapat jelas yang berharga</li>
    <li>Qawiyyu Afrah Nailah gadis yang dianugerahi dengan kebahagiaan dan kekuatan dari Tuhannya</li>
    <li>Qawwamah Hafshah Jennaya bermakna wanita yang gigih dalam mencari rahmat Allah melalui salat malam</li>
    <li>Qaynat Saby Raabi’ah bermakna perempuan muda dan cantik yang bersinar dengan keberuntungan di dunia</li>
    <li>Qistina Luthfiyah Hayati bermakna wanita lemah lembut yang adil demi kehidupan yang penuh keberkahan</li>
    <li>Qistina Rahima Inayah bermakna wanita penuh kasih sayang yang memiliki kekuatan untuk bersikap adil berkat Tuhannya</li>
    <li>Qisya Dhia Aulia bermakna teman wanita yang hidupnya penuh kebaikan dan kedamaian seperti hidup di surga</li>
    <li>Qiyadah Aretha Maysun bermakna pemimpin perempuan berbudi tinggi yang cantik dan saleh</li>
    <li>Qonitah Khairunnisa Adilah bermakna sebaik baik wanita yang adil dan berbakti</li>
    <li>Quaneisha Rafidah Imamah bermakna pemimpin wanita yang datang memberi pertolongan</li>
    <li>Qudamah Najwa Rahmani bermakna wanita penuh kasih sayang yang kata hatinya selalu bergerak maju</li>
    <li>Qudwah Raisa Hanafia bermakna wanita secantik mawar yang dijadikan contoh manusia yang sangat taat pada ajaran agamanya</li>
    <li>Qulaibah Ainin Chayra bermakna kebaikan yang berasal dari mata hati yang suci</li>
    <li>Qulaibah Yumna Azizah bermakna seorang perempuan yang diberkati dengan kemuliaan hati</li>
    <li>Quratulain Sabira Aqlima bermakna gadis dengan mata bercahaya yang penuh kesabaran dan ilmu pengetahuan</li>
    <li>Qurratul Fajriyah Yusra bermakna wanita yang bersinar secerah mentari pagi yang membawa kebahagiaan</li>
    <li>Quthrun Naima Sakinah bermakna wanita dengan keadilan yang mengalir seperti sungai pembawa kedamaian</li>
    <li>Raaina Fadheela Siya bermakna putri cantik pembawa rezeki yang berbudi luhur</li>
    <li>Raaina Hamna Adha bermakna putri cantik yang diberkati karena lahir saat Hari Raya Idul Adha</li>
    <li>Rabia Malda Nafeesa bermakna anak keempat berhati lembut yang berharga</li>
    <li>Radhiyah Salma Maisyah bermakna wanita yang mendapat keridhaan dan keselamatan</li>
    <li>Radya Salima Alzan bermakna perempuan cantik yang benar-benar sempurna dalam segala hal</li>
    <li>Rafanda Maisun Khaliluna bermakna anak perempuan cantik yang beruntung, makmur, dan merupakan kekasih hati orang tuanya</li>
    <li>Raghida Zada Sabrina bermakna wanita yang memiliki kesabaran dan keberuntungan</li>
    <li>Rahifah Nadda Kamila bermakna perempuan dengan ketajaman hati yang menyempurnakannya</li>
    <li>Rahima Nida Zharifah bermakna wajah yang indah dan belas kasih</li>
    <li>Rahimah Afaf Rizkiana bermakna anak yang penyayang, sopan, serta rezekinya baik</li>
    <li>Rahma Haniyah Sadya bermakna perempuan penyayang yang hidup senang dan dalam keberuntungan</li>
    <li>Rahma Qawiya Adha bermakna gadis penyayang yang merupakan pejuang pemberani dan terlahir di Hari Raya Idul Adha</li>
    <li>Rahmah Amalia Haura bermakna wanita bermata hitam yang penuh kasih sayang dan suka beramal</li>
    <li>Raisah Amira Kalani bermakna perempuan yang bagaikan ratu dan memimpin ke surga</li>
    <li>Rajab Aezal Niha bermakna pemberian Allah, cantik, dan menghormati</li>
    <li>Raniah Tamara Aathirah bermakna perempuan harum dengan pesona yang terang-benderang</li>
    <li>Rawdah Sanari Nabiha bermakna perempuan yang diberkati dengan kecantikan dan kecerdasan dari surga</li>
    <li>Rawna Najma Yasira bermakna bintang yang berkerlap-kerlip seperti perhiasan dari surga</li>
    <li>Raya Adira Rashid bermakna wanita dengan kekuatan yang mengalir ke arah yang benar</li>
    <li>Riana Kazem Rida bermakna wanita dewasa yang dilimpahkan oleh Allah dengan cinta</li>
    <li>Rida Hazimah Dzahabiyyah bermakna wanita yang ikhlas memiliki sifat emas dengan keteguhan hati</li>
    <li>Ridha Aurora Zetana bermakna anak perempuan yang dilahirkan di pagi hari dengan jiwa dipenuhi kesederhanaan hati untuk mencari keridhaan</li>
    <li>Rizkiyya Faatina Adeela bermakna wanita menawan pembawa rezeki yang selalu jujur dalam bertutur kata</li>
    <li>Rizqia Ameera Alesha bermakna putri pembawa rezeki yang selalu dilindungi Allah</li>
    <li>Rizqiana Farah Azeeza bermakna anak perempuan terhormat yang diberi kebahagiaan dan rezeki</li>
    <li>Rizqiana Shakierra Zahbia bermakna&nbsp;wanita cantik pembawa rezeki yang senantiasa bersyukur</li>
    <li>Rofifah Talita Roidah bermakna gadis pemimpin yang berakhlak baik</li>
    <li>Roidah Atiqah Suri bermakna pemimpin wanita yang rendah hati</li>
    <li>Rukhansa Aria Humairah bermakna perempuan mulia berpipi indah dan kemerahan</li>
    <li>Rukhsana Farida Aatifa bermakna anak perempuan berharga yang cantik dan dilimpahi kasih sayang</li>
    <li>Rukhsana Misba Mahra bermakna perempuan yang cantik dan bercahaya</li>
    <li>Rumaisha Aiyra Samia bermakna gadis yang berhasil karena selalu mendengarkan perkataan baik dengan penuh kedamaian</li>
    <li>Ruman Nabilah Azzida bermakna kebahagiaan yang sederhana dan penuh cinta</li>
    <li>Ruqayya Faliha Rizqiana bermakna seorang perempuan lembut yang beruntung dan kelak mendapatkan rezeki</li>
    <li>Ruqayyah Humaila Adha bermakna gadis lembut dan berharga seperti kalung emas, terlahir di Hari Raya Idul Adha</li>
    <li>Saara Azizah Rizqiana bermakna perempuan terhormat dan mulia yang dikaruniai rezeki</li>
    <li>Sabia Rafifa Shalimar bermakna wanita cantik yang kuat dan berakhlak baik</li>
    <li>Sabirah Maizah Almahyra bermakna anak cerdik yang sabar dan beruntung</li>
    <li>Sada Amyra Marwan bermakna bangsawan perempuan yang berhasil berkat kekuatannya</li>
    <li>Sada Fiya Nazma bermakna gugusan bintang yang berhasil menguasai langit</li>
    <li>Sadia Musfira Nasreen bermakna putri dengan wajah yang cerah seperti mawar putih</li>
    <li>Safa Misba Amani bermakna perempuan polos yang suci dan memiliki permintaan yang baik</li>
    <li>Safinah Suasan Rahma bermakna perahu dan bunga yang harum dari rahmat Allah</li>
    <li>Safira Adzika Nurrohmah bermakna penulis wanita perempuan cerdas yang lahir sebagai rahmat</li>
    <li>Saifa Fiya Hussein bermakna perempuan berkuasa yang bersinar indah</li>
    <li>Sakhi Akilah Hafizhah bermakna perempuan pintar penghapal Alquran yang murah hati</li>
    <li>Salam Ana Athiyah bermakna perempuan yang dianugerahi dengan kesejahteraan di hidupnya</li>
    <li>Salma Aidah Aria bermakna anugerah anak perempuan mulia yang terlahir selamat</li>
    <li>Salma Zhafira Farah bermakna anak yang tenang, diliputi kebahagiaan, dan beruntung</li>
    <li>Salwa Shabiyyah Azzahra bermakna gadis kecil yang menjadi pelipur lara dan baik serta cerdas</li>
    <li>Samara Zarifa Saidah bermakna gadis cantik dan sukses yang membawa cahaya keberuntungan yang lembut dan menyenangkan</li>
    <li>Sami Adeva Myesha bermakna pendengar baik yang menyenangkan dan berbudi luhur, membuat hidupnya penuh karunia</li>
    <li>Sanaa Aqeela Hamida bermakna gadis cemerlang yang beruntung dan berharga bagi banyak orang</li>
    <li>Savina Adiva Arsyila bermakna anak cantik yang baik hati dan memiliki kehidupan yang tenteram dan lembut hatinya</li>
    <li>Sekar Zahira Bilqis bermakna perempuan cantik seperti bunga&nbsp;bunga yang bersinar terang</li>
    <li>Selena Ghaziyah Sienna bermakna pejuang perempuan yang berani dan anggun</li>
    <li>Shahira Ahza Mersiha bermakna wanita paling cantik yang terkenal dan beruntung</li>
    <li>Shakeela Nada Zanitha bermakna anak yang cantik dengan hati selembut embun</li>
    <li>Shakila Amala Aulia bermakna wanita cantik yang bersemangat untuk memenuhi harapan kedua orang tuanya</li>
    <li>Shakina Ayesha Adha bermakna gadis cantik yang hidup bahagia dan lahir di Hari Raya Idul Adha</li>
    <li>Shanessa Haq Amany bermakna wanita yang berkati dengan cita-cita baik dari Tuhannya yang Maha Benar</li>
    <li>Shanum Rizqia Aisyah bermakna anak yang kehidupannya diberkahi Allah dan dilimpahi rezeki</li>
    <li>Siya Hameeda Zaheera bermakna gadis pembawa rezeki yang cemerlang dan memiliki sifat terpuji</li>
    <li>Suma Talitha Shatara bermakna gadis cantik yang menawan dan ramah tamah</li>
    <li>Surumi Rizqa Athaya bermakna anak cantik yang merupakan rezeki dan anugerah dari Allah</li>
    <li>Syafiqa Fayda Malaika wanita berhati malaikat yang penuh kasih sayang dan suka menolong</li>
    <li>Syamra Az Zaida Zafhirah bermakna wanita sederhana yang mampu memikat perhatian orang karena kemenangannya</li>
    <li>Syarifah Hasna Aqilah bermakna mulia, baik dan terhormat</li>
    <li>Syazani Nur Albirru bermakna anak cerdas yang membawa cahaya kebaikan</li>
    <li>Syifa Salsabila Rahadatul bermakna penyembuh, mendapat kemakmuran di mata air surga</li>
    <li>Taima Shazia Ufairah bermakna wanita cantik yang berkeinginan untuk mencari kebahagiaan sejati di hidupnya</li>
    <li>Taleetha Naila Adzkiya bermakna gadis kecil dengan kecerdasan&nbsp;yang kelak membawanya pada kesuksesan</li>
    <li>Taleetha Zahwa Aretha bermakna gadis kecil yang memiliki kebahagiaan sempurna</li>
    <li>Talia Fauzia Zulfa bermakna gadis berwajah cantik yang dikaruniai dengan penampilan yang indah</li>
    <li>Talita Syarifah Khalidah bermakna gadis mulia yang berakhlak sempurna</li>
    <li>Talitha Adiba Arshiya bermakna gadis yang lahir dengan kehebatan sebagai hadiah dari Tuhannya</li>
    <li>Tamara Hayu Athira bermakna wanita dengan cahaya terang benderang yang mengharumkan namanya dalam kehidupan</li>
    <li>Tamimah Aida Zayna bermakna Perhiasan dengan kecantikan seindah langit yang tinggi</li>
    <li>Tania Aafa Ghazali bermakna peri yang suci dan selalu mengampuni kesalahan orang lain</li>
    <li>Tanisha Asha Hania bermakna perempuan bahagia yang lahir di hari Senin</li>
    <li>Taqiyah Zahra Asmara bermakna gadis yang bernaung cahaya dari cinta Allah karena taat pada agamanya</li>
    <li>Tariqah Haura Luthfiyah bermakna wanita lemah lembut yang menunjukkan jalan kebaikan yang memesona</li>
    <li>Tawaddah Farhah Aqila bermakna wanita lembut dan bijaksana yang hatinya diliputi kebahagiaan sejati</li>
    <li>Tawakkul Amara Latifah bermakna perempuan lemah lembut yang bergantung pada kasih sayang Allah</li>
    <li>Taysirah Nadhifa Kautsar bermakna wanita berhati suci yang memudahkan hidupnya dalam menggapai derasnya aliran sungai surga</li>
    <li>Tazkia Adara Rizqiyah bermakna wanita berhati bersih yang diberkati dengan rezeki yang baik</li>
    <li>Tazkia Naura Amira bermakna wanita berhati murni yang dihiasi cahaya keimanan yang menerangi hidupnya</li>
    <li>Tazkira Siti Sakinah bermakna wanita yang membawa ketenteraman hidup karena sering mengingatkan satu sama lain</li>
    <li>Thalita Ghaisani Naura bermakna anak yang muda dan cantik seperti bunga</li>
    <li>Thamrinah Zahirah Fadhilah bermakna wanita terpandang yang diutamakan oleh banyak orang saking berharga dirinya seperti perhiasan</li>
    <li>Thaniah Jauharah Safiya bermakna wanita suci pembawa kedamaian yang sangat berharga seperti permata</li>
    <li>Tharaa Siti Shafa bermakna wanita baik berhati lembut yang beruntung di hidupnya</li>
    <li>Thifal Salsabila Arini bermakna bidadari yang menyebarkan kebahagiaan, keindahan, dan keasrian di dunia</li>
    <li>Thufailah Zalfa Naima bermakna wanita yang membawa keberuntungan dan keindahan dalam setiap langkahnya</li>
    <li>Tiara Aneesha Haniyyah bermakna wanita yang memiliki hiasan mutiara yang murni</li>
    <li>Tihani Safiya Azra bermakna gadis cerdas yang membawa kedamaian dan kecantikan yang bersinar di mata para pemandang</li>
    <li>Tihara Siti Amani bermakna wanita dengan hati bersih yang membawa kedamaian</li>
    <li>Tisha Shofiyya Inayah wanita penuh kasih sayang yang gemar menolong sesama murni karena ketulusan hatinya</li>
    <li>Tiurma Jihan Hayati bermakna wanita yang berharga di kehidupan banyak orang seperti seluruh perhiasan di dunia</li>
    <li>Tiurma Nayla Safiya bermakna pohon yang bersinar dalam kesucian dan kebijaksanaan</li>
    <li>Tsabitah Atiqah Zayda bermakna wanita cantik berhati teguh yang hidupnya dikaruniai keberuntungan</li>
    <li>Tsabitah Ghaida Amani bermakna wanita cantik berhati teguh yang mendamaikan kehidupannya</li>
    <li>Tsamara Zaynab Hananiah wanita dengan berparas indah yang membawa kehangatan dalam kehidupan</li>
    <li>Tsamarah Ufaira Thalia bermakna dewi cantik dan anggun yang kehadirannya memakmurkan kehidupan</li>
    <li>Tyas Triana Sari bermakna putri yang terlahir dengan jiwa yang murni</li>
</ol>
<ol>
    <li>Ufaira Nayla Almira bermakna ratu pembawa cinta dan kedamaian dengan kecantikan yang cerah dan memesona</li>
    <li>Ufairah Malika Aghnia bermakna ratu berhati selembut rusa yang kaya raya</li>
    <li>Ufairah Qamar Zafirah bermakna wanita dengan keberanian luar biasa yang bercahaya seperti bulan</li>
    <li>Ufairah Zayan Qaidah bermakna wanita selembut rusa dengan kecantikan wajah dan hati yang menjadi prinsip hidupnya</li>
    <li>Ulfa Nabilah Rifaya bermakna wanita yang brilian, cerdik, dan ramah terhadap orang lain</li>
    <li>Ulfa Salma Najibah bermakna keselamatan dan keramahan yang bernilai</li>
    <li>Ulfah Nisrina Liana bermakna wanita dengan cahaya keimanan yang membuat hatinya bersih dan cantik</li>
    <li>Ulfah Rizqiyah Amara bermakna anak perempuan pembawa berkah yang hidup dalam&nbsp;keindahan sejati</li>
    <li>Ulfiana Syahira Sabrina bermakna anak perempuan berseri-seri yang membawa keceriaan</li>
    <li>Umaira Ziva Nafisa bermakna kehidupan dunia yang terang dan berharga</li>
    <li>Umairah Rasya Zahira bermakna gadis yang panjang hidupnya dan memiliki hati penuh empati yang bercahaya</li>
    <li>Umaiza Fatima Zaida bermakna gadis menawan yang lembut hatinya dan beruntung di dunia dan akhirat</li>
    <li>Umaiza Lamya Zahara bermakna anak dengan kecantikan yang bersinar terang seperti bunga mawar</li>
    <li>Umaiza Silmi Heba bermakna anak yang cantik, cerdas, selamat, dan merupakan sebuah hadiah dari Tuhan</li>
    <li>Umayma Widad Khairunnisa bermakna teman wanita dengan hati penuh cinta yang hidup dalam kebaikan</li>
    <li>Umayma Yasmin Faridah bermakna gadis mulia dengan hati yang dipenuhi harapan berbunga-bunga</li>
    <li>Umaymah Zalfa Izzah bermakna gadis cantik dan memesona dengan keagungan dan kelebihan yang banyak</li>
    <li>Umayra Hanina Talitha bermakna perempuan muda yang hidup dengan penuh kebaikan dan kelembutan</li>
    <li>Ummu Habibah Fathinah bermakna wanita menawan yang kelak menjadi sesosok ibu yang dicintai keluarganya</li>
    <li>Unaysah Saraya Juwairiyah putri cantik yang berharga karena memiliki banyak teman</li>
    <li>Urwah Hanan Qonita bermakna wanita penuh kasih sayang yang memiliki ikatan kuat dengan agamanya</li>
    <li>Urwah Yasmin Jannah bermakna wanita dengan kelembutan hati seindah surga</li>
    <li>Uswah Aisha Qaisara bermakna wanita bangsawan yang hidup menjadi teladan yang bersinar</li>
    <li>Uswatun Hasanah Fikriya bermakna wanita cerdas dan bijaksana yang menjadi teladan kebaikan</li>
    <li>Uzaina Yusra Luthfia bermakna gadis tercinta pembawa kesejahteraan yang merupakan hadiah dari Tuhan</li>
    <li>Uzayrah Juwairiyah Nada bermakna perempuan dengan kebijaksanaan dan kedermawanan yang berharga seperti embun pagi</li>
    <li>Uzayrah Samira Hadiyah bermakna wanita yang dilimpahi dengan kesejahteraan mutlak sebagai hadiah yang berharga</li>
    <li>Uzma Jauhar Safira bermakna wanita berhati mulia seperti&nbsp;permata yang membawa kebahagiaan</li>
    <li>Uzma Naura Dzihni bermakna wanita agung dengan pemikiran cerdas yang bersinar cerah</li>
    <li>Uzma Sahla Nadhira bermakna gadis dengan hati lemah lembut yang indah dan istimewa</li>
    <li>Vadiya Nafilah Sabiqah bermakna gadis sederhana yang gemar beribadah dan selalu berusaha menjadi suri tauladan</li>
    <li>Vafira Yaqina Amira bermakna perempuan&nbsp;dengan keyakinan kuat yang menjadi pemimpin adil dan bijaksana</li>
    <li>Vafiyya Yasmin Isra bermakna perempuan sewangi bunga yang setia dalam melakukan perjalanan suci di kehidupannya</li>
    <li>Vaila Nayla Qamar bermakna wanita dari lembah yang memenangkan kehidupan di bawah naungan&nbsp;sinar rembulan</li>
    <li>Vaila Syahira Munira: wanita yang bersinar dan hidup dengan kehormatan serta memberikan cahaya bagi orang lain</li>
    <li>Valiqa Nisa Nazihah bermakna perempuan yang dapat dipercaya dan terhindarkan dari perbuatan dosa</li>
    <li>Vania Zafira Rizqita bermakna gadis yang diberkahi rezeki dan memiliki keberanian yang bersinar</li>
    <li>Vanya Maisarah Zakiyya bermakna gadis cerdas yang hidup dalam kemudahan</li>
    <li>Vanya Zahira Hidayah bermakna wanita yang memberikan cahaya petunjuk dengan kebaikan yang bersinar</li>
    <li>Vanya Zalfa Humaira bermakna perempuan suci dan lembut seperti kembang bunga</li>
    <li>Vara Zhafira Hanifa bermakna perempuan yang menjadi pemenang karena dianugerahi keteguhan hati yang penuh keyakinan</li>
    <li>Varisha Luwiza Insyirah: gadis yang membawa kebahagiaan dan kelegaan dalam kehidupan sekitarnya</li>
    <li>Varsa Yumna Zuhaila bermakna gadis pembawa kebahagiaan yang bersinar seterang bintang di malam hari</li>
    <li>Varsya Yusra Sabrina bermakna gadis pembawa kemudahan dan kecerahan dalam hidup orang-orang di sekitarnya</li>
    <li>Vasilah Zuleikha Wafiyyah bermakna wanita tercinta dengan kecantikan yang bersinar yang setia kepada Allah</li>
    <li>Vatika Raisya Amaliyah bermakna wanita pemberani yang hidupnya sederhana seolah berjalan-jalan di kebun yang indah</li>
    <li>Veda Qistina Humaira bermakna wanita cerdas dengan hati penuh cinta yang selalu berpegang teguh pada agama</li>
    <li>Vega Fattana Nayyara bermakna wanita yang sangat cantik dan bercahaya seperti bintang jatuh</li>
    <li>Velda Aisyah Novita bermakna gadis pembawa keadilan yang bersih hatinya karena hidup sesuai dengan petunjuk Tuhannya</li>
    <li>Velinda Raudatul Iffah bermakna perempuan mulia yang hidup dalam kebijaksanaan dan petunjuk yang benar</li>
    <li>Vilda Haniyah Nuzula bermakna perempuan pembawa ketenangan yang diturunkan ke bumi sebagai anugerah terindah</li>
    <li>Vilda Nashita Fathimah bermakna wanita beruntung yang gemar membantu hingga ia berhasil dan disukai banyak orang</li>
    <li>Viona Arshinta Dzakira bermakna wanita secantik bidadari dengan hati yang suci karena selalu mengingat Allah</li>
    <li>Viona Larasati Kamila bermakna gadis sempurna yang ramah dan berbudi luhur</li>
    <li>Virdiana Nashwa Khalisa bermakna wanita murah hati yang memberikan ketenangan di hati</li>
    <li>Visha Nadira Azmina bermakna perempuan menawan dengan hati murni yang membawa keindahan dan kesucian</li>
    <li>Viviandara Zuhra Falisha bermakna wanita penebar kebahagiaan yang wajahnya selalu bersinar secerah bintang kejora</li>
    <li>Viviandari Qalila Shafiyyah bermakna wanita tersayang dengan wajah ceria yang menjadi penyembuh bagi orang-orang di sekitarnya</li>
    <li>Viviara Ananda Fauziyyah bermakna wanita cerdas yang hidup dalam kebahagiaan dan kemuliaan Tuhannya</li>
    <li>Wada’ah Rana Alifah bermakna wanita yang ramah tamah dalam bersahabat dan dapat diandalkan</li>
    <li>Waddia Salma Abidah bermakna perempuan tenang dan baik hati yang hidupnya santai karena rajin beribadah</li>
    <li>Waddia Shafza Kamilla bermakna orang yang baik hati dengan kesempurnaan dan kesuksesan</li>
    <li>Wadudah Nurayra Amal bermakna wanita baik pekerja keras yang penuh dengan cahaya kasih sayang di hatinya</li>
    <li>Wafa Aminah Adzkiya bermakna wanita sempurna yang cerdas pikirannnya dan dapat dipercaya omongannya</li>
    <li>Wafa Rahmah Hafizhah bermakna perempuan penghapal&nbsp;al-Quran yang sempurna dan penuh kasih</li>
    <li>Wafaa Amirra Fawzia bermakna putri pemenang yang setia kepada Allah</li>
    <li>Wafira Nuzula Hayati bermakna wanita yang hidup dan matinya dilimpahi dengan karunia dari Allah</li>
    <li>Wafiya Dian Nuraira bermakna gadis yang setia membawa cahaya kebaikan penerang dunia</li>
    <li>Wafiya Nasira Aufa bemakna gadis penyabar yang setia dalam menolong satu sama lain</li>
    <li>Wafiya Shazira Arfa bermakna gadis yang setia pada keadilan dan penuh kebanggaan</li>
    <li>Wafiya Yezda Tasmia perempuan yang setia pada Allah dan senantiasa memuji-mujinya</li>
    <li>Wahida Marwah Syahira bermakna wanita&nbsp;unik dengan jiwa besar yang berharga</li>
    <li>Waiza Raudhah Kautsar bermakna wanita yang hidupnya bahagia dan dilimpahi kenikmatan</li>
    <li>Wajida Zuhana Fakhira bermakna wanita pembawa cahaya yang menyenangkan yang menjadi pemenang terhormat</li>
    <li>Wajihah Adha Aliiyah bermakna perempuan berkedudukan tinggi yang terlahir di Hari Raya Idul Adha</li>
    <li>Warda Miesha Umaiza bermakna gadis yang diberkati dengan kecantikan mawar dari Allah</li>
    <li>Wardania Azzahra Hamida bermakna bunga indah yang bercahaya dan selalu mensyukuri hidupnya</li>
    <li>Wardatun Jauza Ilyana bermakna bunga yang memberikan kecintaan dan kekuatan seperti perisai</li>
    <li>Warina Iman Zahira bermakna wanita pemberani yang memancarkan keimanan yang cerah</li>
    <li>Waseela Casilda Layla bermakna wanita cantik dan pemberani yang selalu mendekatkan diri kepada Allah di waktu malam</li>
    <li>Washifah Yaqut Zahirah bermakna anak wanita seperti batu permata yang berkilau</li>
    <li>Wasifi Nazihah Hanifah bermakna muslimah yang dimuliakan dan teguh bertutur kara jujur</li>
    <li>Wasimah Hanan Farhana bermakna wanita cantik dan penyayang yang membawa kebahagiaan dalam setiap langkahnya</li>
    <li>Wasita Zahida Farhana bermakna wanita beriman teguh yang hidup dalam cahaya kebahagiaan</li>
    <li>Wenny Lestari Masyra bermakna wanita abadi yang membawa kedamaian dan kesenangan</li>
    <li>Widadah Hasya Qamaria bermakna wanita dengan cahaya indah yang bersinar seterang rembulan</li>
    <li>Wila Safwah Nadhifa bermakna perempuan berhati bersih dan suci yang menjadi terbaik di antara yang terbaik</li>
    <li>Wisamah Nuzul Amira bermakna wanita yang diberikan cahaya keagungan dan kemuliaan</li>
    <li>Xafira Azura Fathia bermakna perempuan bercahaya yang diberkati dengan kebahagiaan</li>
    <li>Xaia Nisrina Felisha bermakna wanita seharum bunga yang cantik, cerdas, dan hidup dalam kebahagiaan</li>
    <li>Xaifa Syahla Azzahra bermakna wanita yang hidup dalam keagungan dan keindahan</li>
    <li>Xaiza Ilhamiyyah Haura bermakna wanita bijaksana yang diilhami hati semurni warna putih dari Allah</li>
    <li>Xaiza Zalfa Azizah bermakna wanita yang dicintai dan dimuliakan karena hatinya yang terang</li>
    <li>Xalena Husna Zakiyah bermakna wanita cantik dengan hati murni yang bercahaya</li>
    <li>Xaliah Aqila Rasyida bermakna perempuan bijaksana dengan kekuatan sedalam lautan yang memikat</li>
    <li>Xalifa Syarifah Althafi bermakna gadis yang mewariskan kehormatan dan keanggunan</li>
    <li>Xalima Zahira Marwah bermakna wanita berharga yang bersinar karena tutur katanya yang lemah lembut</li>
    <li>Xaliqa Nurul Hikmah bermakna wanita yang dianugerahi cahaya petunjuk yang suci dan penuh hikmah</li>
    <li>Xalisha Naurah Amani bermakna perempuan amanah dengan keindahan alami yang membawa kedamaian</li>
    <li>Xaluna Amani Zahra bermakna gadis yang membawa cahaya kedamaian yang bersinar murni</li>
    <li>Xanaya Faiqa Zuhaira bermakna wanita dengan keberanian sempurna yang senantiasa mengingat Tuhannya</li>
    <li>Xandra Eleia Zuhara bermakna wanita bangsawan yang melindungi umat manusia dengan keberanian seterang bintang kejora</li>
    <li>Xandria Sinta Khafia bermakna gadis yang membuat jalan menuju kesejahteraan umat manusia sejak kecil</li>
    <li>Xara Omesha Farshana bermakna putri bijaksana yang hidup dalam kemegahan</li>
    <li>Xariya Yiesha Adara bermakna wanita feminin pembawa cinta yang hidup dalam kehormatan</li>
    <li>Xayla Hafiza Rizqiyah bermakna wanita yang diberkati dengan rezeki dan ilmu yang terjaga oleh Allah</li>
    <li>Xayla Nurin Zainah bermakna wanita penuh gairah dengan kecantikan yang tercipta dari cahaya</li>
    <li>Xeira Faizaan Karmila bermakna gadis manis dengan cinta dan kebaikan abadi yang melimpah ruah</li>
    <li>Xena Nashwa Arafah bermakna tamu perempuan yang datang sebagai penjaga yang wangi</li>
    <li>Xeya Sayyida Quraisya bermakna wanita kuat yang muncul memberikan inovasi bermanfaat</li>
    <li>Xiraatul Husnaini Raisha bermakna ratu adil dengan kecantikan luar dan batin</li>
    <li>Xiyadah Shofiyyah Akifa bermakna perempuan yang gigih mencari kebenaran dan setia kepada agama Allah</li>
    <li>Xufaira Salwa Qonitah bermakna wanita rendah hati yang lapang hatinya karena tekun beribadah</li>
    <li>Xulayfa Madiha Hazaiah bermakna gadis cerdas dengan sifat terpuji yang selalu dilihat Tuhannya</li>
    <li>Xyara Syahida Arni bermakna wanita yang menjadi saksi kebenaran yang bersinar seterang mentari</li>
    <li>Xyra Arissa Haura bermakna wanita menggemaskan yang tiap ucapannya adalah kebenaran yang bersinar</li>
    <li>Xyra Azalea Humaira bermakna gadis menggemaskan dengan kecantikan seperti bunga merah</li>
    <li>Yalda Alisha Maram bermakna gadis terhormat yang hatinya penuh harapan dari pagi hingga malam</li>
    <li>Yalda Muthiah Zaynab bermakna gadis wangi berhati lembut yang lahir di malam hari</li>
    <li>Yalda Raniah Azwira bermakna ratu bermartabat tinggi yang bijaksana dan lahir di malam hari</li>
    <li>Yalina Nazira Hanifa bermakna wanita berhati bersih dengan visi yang tajam dan setia pada prinsip agama</li>
    <li>Yaluna Ilma Wafiya bermakna gadis setia dengan ilmu pengetahuan yang luas dan kejujuran yang tinggi</li>
    <li>Yameena Amala Zuwaina bermakna wanita makmur yang diberkati dengan harapan di hatinya</li>
    <li>Yamina Taj Inayah bermakna gadis yang peduli, berharga bak permata, dan dirahmati Allah</li>
    <li>Yamna Noor Fatimah bermakna wanita yang membawa cahaya kebahagiaan yang suci</li>
    <li>Yaqootah Najma Saqlain bermakna permata yang bersinar seterang bintang pembawa keberuntungan dan kejayaan</li>
    <li>Yara Farrah Falguni bermakna wanita cantik dan indah seperti kupu-kupu kecil</li>
    <li>Yareen Nadira Barakah bermakna gadis berharga yang diberkati dengan kebahagiaan yang mengalir</li>
    <li>Yasin Anah Aiza bermakna wanita kaya raya yang dimuliakan karena ketabahan dan kesabaran hatinya</li>
    <li>Yasmin Aliya Mumtazah bermakna perempuan mulia yang istimewa laksana bunga melati</li>
    <li>Yasmin Salsa Zainab bermakna perempuan yang baik hati, cantik, dan wangi seperti bunga melati</li>
    <li>Yasmine Numa Taqiyyah bermakna wanita bertakwa dengan kecantikan seindah bunga melati</li>
    <li>Yasna Juhayrah Amira bermakna putri yang memimpin dengan penuh keberanian karena hatinya yang murni seperti melati putih</li>
    <li>Yatiimah Durratul Saudah bermakna pemimpin wanita yang berharga seperti mutiara hitam</li>
    <li>Yesenia Tahiyyah Samiyyah bermakna bunga yang memiliki kehormatan dan kemuliaan</li>
    <li>Yiesha Denia Farras bermakna wanita hebat dan jujur dalam bertutur kata</li>
    <li>Yuditha Faiqah Alayna bermakna gadis cantik pemikir kritis yang kelak bangkit dalam kesuksesan</li>
    <li>Yumaira Rukhshar Qaisara bermakna gadis berwajah seindah bulan yang menjadi pemimpin terhormat</li>
    <li>Yumaira Zafira Anwariyyah bermakna wanita lembut pembawa cahaya yang kelak akan menjadi peneliti sukses</li>
    <li>Yumairah Asifa Rukaiya bermakna gadis berhati jernih yang hidup dalam kedamaian dan keberkahan hidup</li>
    <li>Yumna Alzena Hamida bermakna perempuan yang beruntung dan berharga</li>
    <li>Yumna Zahra Maimunah bermakna bunga yang tumbuh menjadi pertanda baik akan datangnya keberuntungan</li>
    <li>Yumnah Syifa Tasmira bermakna bunga penyembuh yang membawa keberkahan</li>
    <li>Yusra Hada Shukriyah bermakna gadis mulia yang hidupnya sejahtera karena senantiasa bersyukur</li>
    <li>Yusra Nawal Myeshia bermakna perempuan dengan kehidupan sejahtera yang diberikan dari Allah sebagai hadiah bagi kedua orang tuanya</li>
    <li>Yusrina Hana Ilhamiyyah bermakna wanita yang diberkati dengan kebahagiaan dan cahaya ilahi</li>
    <li>Zaara Sarah Jawahir bermakna putri cantik yang berhiaskan cahaya terindah</li>
    <li>Zada Aqilah Ayda bermakna perempuan cerdas yang beruntung</li>
    <li>Zafeera Mysha Dharirah bermakna wanita penyabar dan sukses yang bahagia seumur hidupnya</li>
    <li>Zafirah Rahma Azzahra bermakna wanita sukses yang menyayangi sesama dengan cahayanya</li>
    <li>Zafrat Samara Khaliya bermakna perempuan mandiri yang kuat dan dapat melindungi dirinya sendiri serta orang lain</li>
    <li>Zahara Kaamla Adha bermakna anak gadis sempurna yang bersinar dan lahir saat Idul Adha</li>
    <li>Zahira Nayyara Mardhiyah bermakna gadis dengan ketaatan pada agamanya yang bersinar seterang bintang</li>
    <li>Zahirah Nur Shabirah bermakna wanita yang sabar dan cantik berkilau seperti cahaya</li>
    <li>Zahra Jannah Alesha bermakna perempuan sewangi bunga mawar di surga yang senantiasa dilindungi oleh Allah</li>
    <li>Zahwa Shaqueena Adiba bermakna anak perempuan seperti ratu yang berpembawaan tenang, cantik, beradab, serta berpengetahuan</li>
    <li>Zaimah Bilqis Adzkiya bermakna ratu yang mampu memimpin dengan penuh kecerdasan</li>
    <li>Zainab Faiqah Savitri bermakna wanita cantik dengan cahaya cerah yang unggul dan menenangkan hati</li>
    <li>Zainura Izzah Safwanah bermakna gadis dengan cahaya kecantikan yang kuat seperti batu permata</li>
    <li>Zaira Anum Hasan bermakna tamu perempuan bersifat indah yang merupakan hadiah dari Allah</li>
    <li>Zakiyyah Hafna Aziza bermakna wanita berhati murni yang kuat menghadapi segala cobaan di hidupnya</li>
    <li>Zalsa Syaffira Asheeqa bermakna anak perempuan yang dicintai, istimewa dan bermartabat</li>
    <li>Zara Saqina Hapsari bermakna putri saleh yang dinaungi cahaya kedamaian seluas dan sedalam samudra</li>
    <li>Zarine Adha Khaira bermakna cahaya yang bersinar dengan bagus dan muncul di Hari Raya Idul Adha</li>
    <li>Zayana Risma Qasira bermakna gadis cantik berhati sabar yang selalu beruntung di hidupnya</li>
    <li>Zayba Afsheen Fayruz bermakna perempuan cantik bagaikan&nbsp;permata yang bersinar seperti bintang di langit</li>
    <li>Zayba Shazia Nuzairah bermakna perempuan terhormat dengan hati dan paras yang sangat cantik</li>
    <li>Zayna Argani Namiera bermakna wanita cantik yang berani menempuh bahaya secara menyeluruh</li>
    <li>Zea Riza Safiya bermakna wanita tenang dan bercahaya yang selalu menjaga kehormatannya karena takut pada Allah</li>
    <li>Zeannisa Faatina Khayira bermakna wanita cantik yang saliha&nbsp;dan memikat hati</li>
    <li>Zeeana Aaila Adha bermakna gadis cantik nan berharga seperti perhiasan yang terlahir di Hari Raya Idul Adha</li>
    <li>Zia Shaqueena Akleema bermakna wanita cantik seperti ratu yang berpembawaan tenang dan bersinar</li>
    <li>Ziya Ayad Nyra bermakna wanita seindah mawar yang bersinar dengan penuh kekuatan</li>
    <li>Zuhairah Jannah Syakira bermakna wanita yang kelak akan merasakan cahaya surga karena selalu bersyukur</li>
    <li>Zyana Salwa Aliza bermakna berkat dari surga yang membawa kebahagiaan</li>
</ol>


1. Alana Zahira Malika - yang mengagumkan, berseri, ratu

2. Aisyah Azka Amani - hidup, murni, kedamaian

3. Amanda Zara Kirana - dicintai, bunga, sinar

4. Almira Cinta Putri - yang dihargai, cinta, putri

5. Adeline Zivana Rania - penuh kelembutan, bersinar, tanah air

6. Adara Elvira Chelsea (kecantikan)

7. Aisha Amani Indah (damai, indah)

8. Amanda Beatrice Kirana (penuh keberanian, sinar)

9. Ayana Celine Natasha (bulan, suci)

10. Agatha Clara Josephine (baik hati, berkuasa)

11. Aisyah Zahra Nabila (Hidup, bunga, mulia)

12. Amanda Natasha Sari (Penerima, beriluminasi, harta)

13. Amira Putri Salma (Pemimpin, putri, selamat)

14. Aurel Zahra Amanda (Gilang, bunga, penerima)

15. Ayra Zahra Amanda (Yang memiliki cahaya, bunga, penerima)

16. Bella Zalfa Aryani - cantik, cerdas, mulia

17. Bianca Zayla Azalea - putih, perindu, semarak

18. Beyoncé Zuri Liana - wanita yang luar biasa, cantik, melati



19. Britney Zafira Ayla - kuat, penolong, sinar bulan

20. Bintang Zalfa Aulia - cahaya, cerdas, keagungan

21. Bunga Kamila Fadia (Bunga, sempurna, keberuntungan)

22. Bella Zahra Amanda (Cantik, bunga, penerima)

23. Bilqis Zahra Salwa (Wanita yang dihormati, bunga, penyelamat)

24. Balqis Zahra Salma (Bulan purnama, bunga, selamat)

25. Bintang Zahra Salma (Bintang, bunga, selamat)


26. Brenda Devi Felicia (teman, surgawi)

27. Bella Eileen Grace (cantik, terang)

28. Cinta Elvira Hanna (kasih, kemuliaan)

29. Calista Zia Nadira - yang paling cantik, hidup, langka

30. Cassandra Zahra Aqila - pembawa kebahagiaan, bunga, cerdas

31. Chelsea Zara Audra - cerdas, putri, kuat

32. Chintya Azalea Naira - cantik, semarak, bercahaya



33. Cynthia Zahira Alisha - manusia yang suci, berseri, dilindungi

34. Calista Zahra Amanda (Yang paling cantik, bunga, penerima)

35. Cinta Zahra Salma (Cinta, bunga, selamat)

36. Chandara Zahra Amanda (Bulan, bunga, penerima)

37. Chandra Zahra Salma (Bulan, bunga, selamat)

38. Clarisa Zahra Amanda (Terkenal, bunga, penerima)

39. Dara Fira Isabella (ratu, indah)

40. Dian Giselle Jocelyn (cahaya, berjiwa mulia)

41. Deandra Zafira Nayla - yang memiliki kekuatan, penolong, raja

42. Delisha Zara Aisha - raja, putri, kehidupan

43. Davita Zahra Amani - yang dicintai, bunga, kedamaian

44. Dianti Azra Zulfa - matahari terbenam, putih, murni

45. Dheana Zalfa Azahra - cinta, cerdas, bunga

46. Dania Zahra Salma (Kecerdasan, bunga, selamat)

47. Dara Zahra Amanda (Ratu, bunga, penerima)

48. Dewi Zahra Salma (Dewi, bunga, selamat)

49. Delia Zahra Amanda (Yang halus, bunga, penerima)

50. Damara Zahra Salma (Yang kelima, bunga, selamat)

51. Elvira Zahira Amira - yang mengagumkan, berseri, pemimpin

52. Elisha Zara Nadira - Tuhan yang menyelamatkan, putri, langka

53. Elsya Zalfa Aqila - suci, cerdas, kuat


54. Elvina Zahra Kirana - yang mengagumkan, bunga, sinar

55. Emily Zara Azalea - yang gigih, putri, semarak

56. Elma Kiana Nadira (berkilau, langka)

57. Elsa Felicia Grace (kebahagiaan, anugerah)

58. Erlina Zahra Amanda (Maju, bunga, penerima)

59. Elvira Zahra Salma (Yang benar, bunga, selamat)

60. Erika Zahra Amanda (Raja, bunga, penerima)

61. Elvina Zahra Salma (Siapa yang disajikan, bunga, selamat)

1. Felicia Rania Safira (berarti: kedamaian yang indah)

2. Fira Zahra Amanda (berarti: bunga matahari yang cantik)

3. Farah Nadira Syakira (berarti: cahaya keselamatan yang indah)

4. Fawzia Azzahra Nafisa (berarti: kemegahan bunga yang berharga)

5. Fathia Rara Adinda (berarti: kebahagiaan putri yang cantik)

6. Fadhila Zahra Khairunnisa (Fadhila: Mulia, Zahra: Bunga, Khairunnisa: Wanita baik)

7. Farah Adelia Putri (Farah: Kesenangan, Adelia: Kebajikan, Putri: Putri)

8. Fadilla Kaila Zara (kebaikan, seperti ratu, berbunga)

9. Fiona Aisha Zahra (putri kecil yang hidup)

10. Frida Salma Farah (penyelamat, aman, kegembiraan)

11. Farah Alisha Zara (Gembira, Terlindung, Putri)

12. Fara Yasmine Chandra (Pandai, Bunga Melati, Bulan)

13. Fathia Kirana Zahira (Kejayaan, Cahaya, Keindahan)

14. Fira Belle Aurora (Cahaya, Indah, Sangat Terang)

15. Giselle Kayla Astra (Janji, Murni, Bintang)

16. Gita Rania Isadora (Lagu Suci, Ratu, Hadiah Dewi)

17. Grace Liana Valentina (Anugerah, Pohon Willow, Berani)

18. Galena Salsabila Naura (Milik Tuhan, Sangat Beruntung, Cahaya)

19. Gabriella Aisyah Nada (Allah adalah kebaikan, hidangan)

20. Grace Batari Yara (anugerah, ratu jelita)

21. Giselle Keira Anabelle (berarti: anggun yang bersinar seperti bunga)

22. Gwyneth Nasya Aurelia (berarti: murni yang bersinar cemerlang)

23. Galuh Zahira Natasha (berarti: cahaya yang bersinar indah seperti bunga)

24. Grace Adira Winona (berarti: anugerah dari yang maha kuasa yang penuh kebahagiaan)

25. Gabriella Latisha Nayla (berarti: wanita yang kuat dengan kegembiraan yang indah)

26. Hana Alesha Zahira (bunga yang cantik, dilindungi, cahaya)

27. Haniya Amira Zara (kebahagiaan, putri, berbunga)

28. Hesti Yolanda Bella (Kesetiaan, Violet, Cantik)

29. Hana Freya Zafira (Senang, Tuhan, Cantik, Kebanggaan)

30. Hilda Malika Zahra (Pejuang, Ratu, Mawar)

31. Hana Alya Zahirah (berarti: keindahan cahaya yang bersinar jelas)

32. Hannah Zara Keysha (berarti: anugerah yang indah dan berharga)

33. Harper Jasmine Faye (berarti: pemimpin yang indah dengan keceriaan yang bersinar)

34. Hailey Chandra Devina (berarti: kekuatan yang indah dari bulan)

35. Hilda Farah Mawarini (berarti: wanita yang membawa kebahagiaan seperti bunga mawar)

36. Irena Nabella Althea (Damai, Cantik, Penyembuh)

 37. Iris Malena Shafira (Pelangi, Ratu, Jernih)

38. Inaya Aqila Zahira (Pertolongan, Bijaksana, Bersinar)

39. Imani Khayra Azka (Iman, Baik, Cahaya)

40. Irisa Zahra Shafira (berarti: kecantikan dan keindahan cahaya yang bersinar)

41. Imelda Darlina Vania (berarti: kuat dan indah seperti mawar liar)

42. Inara Zephyra Arissa (berarti: kejelasan dan cahaya yang bersinar indah)

43. Imani Rania Salwa (berarti: keyakinan akan kedamaian dan keselamatan)

44. Imelda Farah Nadhira (berarti: kekuatan dan kebahagiaan dari cahaya yang indah)

45. Jasmine Elvira Yasmin (Bunga Melati, Seperti Kebenaran, Bunga Melati)

46. Juliana Keisha Aisha (Mewah, Aisha, Kehidupan)

47. Jessica Raisa Zahrah (Tuhan Melihat, Penuh Perhatian, Bunga)

48. Jocelyn Jesinta Clara (Gembira, Diterima, Terang)

49. Jasmine Amelia Indira (berarti: bunga yang indah dengan kecantikan yang halus)

50. Janice Zahra Samantha (berarti: wanita yang berharga dengan kecantikan yang bersinar)

51. Jemima Alya Zahirah (Jemima: Merpati, Alya: Tinggi, Zahirah: Bersinar)

52. Jasmine Khadijah Aisyah (bunga melati, awal, hidup indah)

53. Jessica Dian Ayra (keimanan, bulan, purnama)

54. Jocelyn Nayla Zahira (riang, yang indah, cahaya)



1. Kaila Azka Safira - Kaila (kekasih), Azka (pemberani), Safira (permata biru)

2. Keisha Aulia Rania - Keisha (kebanggaan), Aulia (yang mulia), Rania (ratu)

3. Kiana Zalfa Zahira - Kiana (bunga anggrek), Zalfa (cantik), Zahira (bersinar)

4. Kyla Fathia Nadya - Kyla (cantik), Fathia (pemenang), Nadya (berbicara dengan nyaring)

5. Kylie Zahra Qisya - Kylie (indah), Zahra (bunga), Qisya (hidup)

6. Khaira Azka Alisha (Indah, cahaya, dilindungi)

7. Kalya Zara Safira (Pohon jujur, bunga cantik, batu permata)

8. Kirana Aulia Zahira (Bintang kecil, bangsawan, cahaya, gemerlap)

9. Keira Aurelina Jovanka - Keira (gelap), Aurelina (emas), Jovanka (yakin)

10. Kyla Elvira Nadira - Kyla (indah), Elvira (musik), Nadira (langka)

11. Kaia Elvina Kalista - Kaia (laut), Elvina (sahabat), Kalista (paling cantik)

12. Kalista Elysia Nayla - Kalista (paling cantik), Elysia (kebahagiaan), Nayla (cahaya)

13. Keisha Emilia Nasya - Keisha (hidup), Emilia (keren), Nasya (pengaruh)

14. Khaira Eirene Natasha - Khaira (baik), Eirene (damai), Natasha (natal)

15. Laras Salsabila Adinda - Laras (nyanyian), Salsabila (sungai di surga), Adinda (yang dicintai)

16. Livia Aradhana Maulidina - Livia (biru langit), Aradhana (pujaan), Maulidina (dilahirkan dengan mulia)

17. Luthfiyyah Zahira Naysila - Luthfiyyah (penyayang), Zahira (bersinar), Naysila (yang mulia)

18. Lyra Sabrina Farhana - Lyra (pembawa harapan), Sabrina (wanita yang sabar), Farhana (ceria)

19. Lilyana Farisha Azahra - Lilyana (bunga lili), Farisha (kebahagiaan), Azahra (bunga)

20. Luna Eva Marcella - Luna (bulan), Eva (napas kehidupan), Marcella (perintis)

21. Lyra Mahesa Kirani (Hujan lebat, agung, cahaya)

22. Liora Elvina Nayla - Liora (cahaya), Elvina (sahabat), Nayla (cahaya)

23. Leona Elvira Nadira - Leona (singa), Elvira (musik), Nadira (langka)

24. Lilian Eirene Natasha - Lilian (murni), Eirene (damai), Natasha (natal)

25. Layla Elysia Noviara - Layla (gelap), Elysia (kebahagiaan), Noviara (baru dan senang)

26. Livia Aurelina Jovanka - Livia (biru), Aurelina (emas), Jovanka (yakin)

27. Lania Zalfa Syakira (Hijau, cantik, bersyukur)

28. Lovita Zahira Keysha (Cinta, cahaya, sempurna)

29. Maira Aqila Alya - Maira (bersinar), Aqila (cerdas), Alya (tinggi, mulya)

30. Malika Zahra Kirana - Malika (ratu), Zahra (bunga), Kirana (sinar)

31. Malika Zahra Kirana (Ratu, bunga, cahaya)

32. Marsya Alisha Naira (Bintang, dilindungi, cantik)

33. Marsha Zalfa Nadira - Marsha (kecantikan), Zalfa (cantik), Nadira (langka)

34. Maudy Aisha Ainun - Maudy (luar biasa), Aisha (hidup), Ainun (mata air)
35. Mayra Zara Lathifah - Mayra (wanita yang terhormat), Zara (bunga), Lathifah (lembut)

 36. Maylani Zara Salsabila (Mata air, bunga cantik, sungai di surga)

37. Naila Zahra Aqila - Naila (pemenang), Zahra (bunga), Aqila (cerdas)

38. Naura Farah Dania - Naura (cahaya), Farah (gembira), Dania (yang memiliki kecerdasan)

39. Nayla Zara Mushlihah - Nayla (cahaya terang), Zara (bunga), Mushlihah (yang saleh)
40. Nia Salwa Azzahra - Nia (cahaya), Salwa (kedamaian), Azzahra (yang berseri)

Atika Fithriya Tsabita: Seseorang dengan hati yang mulia dan teguh

Arumi Nasha Razeta: Keturunan putri Nabi Adam yang cantik seperti bunga yang wangi

Afifah Hilya Nafisah: Perempuan yg berharga dan memiliki kemuliaan yg tinggi.

Basyira Syadza Nashira: Pembawa kabar gembira yang sangat pintar dan harum namanya.

Bahiyya Atiqa Faiha: yang cantik, indah dan banyak kelebihannya.

Balqis Khansa Alya: Perempuan yg tinggi derajatnya dan baik laksana ratu Balqis

Chayra Ainin Qulaibah: Kebaikan yg berasal dari mata hati yg suci.

Chayra Rahmah Jamilah: perempuan cantik yg penuh dengan kebaikan dan kasih sayang yg besar.

Daliya Karimatun Nisa: Perempuan terhormat dan harum seperti bunga Dahlia

Davina Nur latifah: Cahaya cinta yg lemah lembut

Davina Zaila Hamidah: Perempuan tercinta yg suka memuji-Nya.

Erina Syifa Muthmainnah: Perempuan cantik sebagai obat bagi ketentraman manusia.

Faiza Tazkia Shafia: Perempuan yang beruntung dan suci
Ghina Ulya Syarifah: Perempuan berbudi luhur, dan bermartabat

Gamila Naura Zaida: Wanita yang cantik, yang selalu menyebarkan kebaikan dan keberuntungan.

Erina Syifa Muthmainnah: Perempuan cantik sebagai obat bagi ketentraman manusia.<br /><br />Faiza Tazkia Shafia: Perempuan yang beruntung dan suci
Ghina Ulya Syarifah: Perempuan berbudi luhur, dan bermartabat
Gamila Naura Zaida: Wanita yang cantik, yang selalu menyebarkan kebaikan dan keberuntungan.

Hanin Raihana Syahira: Wanita yang terkenal akan kebaikan hatinya dan seseorang yang penuh cinta

Hanin Hanania: Anak perempuan yang dicintai dan mencintai Tuhan

Hana Dalilatul Inayah: Perempuan yg mudah mendapatkan rezeki sebagai tanda perhatian Tuhan.

Jaida Tsamrotul Fuada: Perempuan baik hati yang dicintai

Julwa Jumanatul Rayah: Wanita cerdas yang menjadi mutiara kehidupan

Kayesa Asma Fatina: Perempuan yang cerdas dan mengagumkan seperti putri Nabi

Kaisa Marhamah Sajihah: Perempuan yang manis, pintar dan mendapatkan keberkahan Tuhan

Labiqa Kabsya Abidah: Pemimpin yang berani dan selalu bekerja keras

Lulu Hilyah Adzkiya: Perhiasan, mutiara hati yang pandai

Mazaya Hikmah Nafisah: Perempuan istimewa yg bijak dan berharga.

Mahreen Shafana Almahyra: Perempuan cerdas yang menghiasi hidupnya dengan kejujujuran

Malika Nufa Aziza: Ratu yang paling cantik dan mulia Qafiya Nurul Jannah: Perempuan yg pandai menghormati orang lain dan menjadi ahli surga.

Qamira Nur Syifa: Wanita dengan hati yang bersih, penuh dengan cahaya penyembuhan

Rasahana Shafwa Ruqayah: Wanita yang tenang dan tulus dalam cinta

Rana Aqila Humaira: Wanita cantik dan sosok mengagumkan yang cerdas

Shafira Nurul Husna: Perempuan yg memiliki kulit kekuning-kuningan dan memancarkan cahaya yg baik.
Sarah Lutfiya Jamilah: Wanita yang cantik, pembereani dan bersemangat

Shanum Diya Syakira: Wanita yang diberkahi Tuhan dan selalu bersyukur dengan penuh sukacita

Talita Hasna Halimah: Gadis Cantik yg Sabar dan Tawakal.

Thafana Nisa Kamila: Wanita baik hati yang sempurna
Tamima Anisatul Maliha: Perempuan sempurna yg ramah dan manis.

Utsratun Nisa Aliah: Perempuan yang menjadi panutan sekaligus tinggi martabatnya

Ulya Hana Mahdyah: bunga cantik yg utama dan merupakan hidayah dari Allah.

Wafa Nuha Nujabah: Wanita yang mudah dicintai, ceria dan dermawan

Watsiqa Mazna Muniya: Perempuan yang dipercaya, bersinar dan sukses
Yadya Azkiyatul Maulida: Perempuan pandai yg terlahir dengan bersih dan suci.

Yasmina Qismiya Nazhifa: Suci dan berwajah cantik seperti bunga Jasmine.

Yumna Nurul Huda: Perempuan yg Mendapat Berkah dan Cahaya Petunjuk.
Zafira Hasna Nafisah: Perempuan indah yg berharga dan murah hati.

Zaphira Ayu Lutfiah: mutiara yg cantik dan lembut.