Adam: Manusia pertama di bumi
Adnan: Seseorang yang bijaksana
Arlo: Bukit berbunga
Asher: Bahagia dan diberkati
Axel: Sumber kedamaian
Ares: Dewa perang dalam mitologi Yunani
Apollo: Dewa matahari, musik, dan kesenian
Atlas: Pembawa dunia di pundaknya
Archer: Pemanah handal
August: Mulia dan agung
Aiden: Api kecil yang bersinar
Adrian: Berasal dari laut
Alden: Teman lama yang setia
Azure: Warna biru langit yang cerah
Aurelius: Keemasan
Atticus: Dari Attica, bijaksana
Altair: Bintang terang di langit
Alaric: Penguasa yang perkasa
Angelo: Malaikat atau utusan
Arrow: Arah dan tujuan yang jelas
Armani: Ksatria atau pejuang
Adriel: Kawanan Tuhan
Ace: Unggul, nomor satu
Azriel: Sang penolong

Baldev: Dewa yang penuh kekuatan
Baldwin: Teman yang pemberani
Blaze: Api yang menyala-nyala
Brooks: Aliran sungai kecil
Beau: Tampan dan menawan
Byron: Dari rumah kecil
Beckham: Rumah di dekat sungai
Barrett: Kekuatan beruang
Bodhi: Pencerahan spiritual
Bowie: Berambut pirang
Bellamy: Teman baik yang setia
Benedict: Yang diberkati
Blue: Warna langit dan laut
Bastian: Yang dihormati
Briar: Semak berduri
Bruce: Dari hutan
Blair: Dataran atau medan
Brock: Badger, simbol kekuatan
Bryson: Anak dari orang terhormat
Beacon: Cahaya pemandu
Bishop: Pengawas atau penjaga
Bruno: Berwarna coklat, kuat
Bay: Teluk yang indah
Bowen: Anak laki-laki bangsawan

Caleb: Setia dan berani
Cyrus: Matahari
Cedric: Kepala perang yang gagah
Cassius: Kosong, bebas
Ciel: Langit dalam bahasa Prancis
Cipher: Kode rahasia
Caelum: Surga atau langit
Calloway: Batu yang halus
Creed: Keyakinan, prinsip
Cove: Teluk kecil yang indah
Cassian: Kosong, tidak bergantung
Cruz: Salib, simbol iman
Caius: Bahagia dan ceria
Canon: Hukum atau peraturan
Caelan: Langsing dan tampan
Crane: Burung bangau yang anggun
Clove: Rempah harum
Cobalt: Warna biru tua
Caspian: Dari laut Kaspia
Crimson: Merah tua yang megah
Cairo: Pemenang, penakluk
Chester: Dari kamp benteng
Cloud: Awan di langit
Cullen: Tampan

Dash: Cepat dan gesit
Dante: Abadi, bertahan
Dion: Anak dewa anggur
Drake: Naga atau pejuang
Dawn: Fajar, awal yang baru
Darius: Memiliki kebaikan
Dorian: Dari laut
Dakota: Teman atau sekutu
Dexter: Terampil dengan tangan kanan
Draven: Petarung, pemburu
Daxton: Penjelajah yang penuh semangat
Dune: Bukit pasir yang indah
Dusk: Senja, waktu matahari terbenam
Dustin: Pejuang yang berani
Dimitri: Pencinta bumi, setia
Darcy: Gelap
Dex: Keterampilan dan kehormatan
Donovan: Ksatria gelap
Denver: Penyeberangan hijau
Desmond: Dari dunia selatan
Dalton: Dari lembah kota
Devlin: Pemberani dan gagah
Dior: Emas, berharga
Denzel: Benteng tinggi

Elijah: Tuhanku adalah Yahweh
Eden: Surga atau kebahagiaan
Echo: Gema suara di kejauhan
Evander: Busur yang baik
Enzo: Penguasa rumah
Ezra: Penolong
Elio: Matahari
Everest: Puncak tertinggi
Elian: Menyinari, bersinar
Ember: Bara api yang masih menyala
Eamon: Pelindung kekayaan
Eirian: Terang, bersinar
Ellis: Ramah, baik hati
Emery: Kuat, pemberani
Everly: Dari padang rumput babi hutan
Edmund: Pelindung kekayaan
Enzo: Penguasa di rumahnya
Emir: Pangeran, pemimpin
Elias: Yahweh adalah Tuhanku
Everett: Kuat seperti babi hutan
Elan: Semangat, gairah
Ellington: Dari tempat Ellis
Eagle: Burung elang yang gagah
Esmond: Pelindung

Finn: Putih, tampan
Flynn: Anak berambut merah
Felix: Bahagia, beruntung
Frost: Embun beku
Forest: Hutan yang teduh
Fox: Cerdik seperti rubah
Fiero: Api yang membara
Falcon: Burung elang
Fenix: Burung api yang bangkit kembali
Florian: Berbunga, berkembang
Fabian: Petani kacang
Finch: Burung kecil yang merdu
Fletcher: Pembuat panah
Fraser: Berasal dari daerah stroberi
Forrest: Dari hutan
Foster: Penjaga hutan
Flint: Batu api
Farley: Dari padang domba
Frey: Tuhan Norse kuno
Fisher: Nelayan
Farid: Unik, tak tertandingi
Fulton: Tempat burung
Fritz: Damai, tenang
Ford: Penyeberangan sungai


Gael: Orang Gael dari Skotlandia/Irlandia
Grey: Warna abu-abu
Griffin: Makhluk mitos berkepala elang
Gage: Janji atau jaminan
Gideon: Penebang pohon
Ghost: Roh atau bayangan
Galaxy: Kumpulan bintang
Garnet: Batu permata merah
Grayson: Anak dari pengawas
Glenn: Lembah yang indah
Galen: Penyembuh
Gatsby: Orang asing yang agung
Gale: Angin yang kencang
Graham: Rumah di kerikil
Guthrie: Angin kencang
Garrison: Benteng pertahanan
Galahad: Ksatria suci
Grove: Kelompok pohon
Galileo: Dari Galilea
Grissom: Anak dari lelaki abu-abu
Gunner: Pejuang dengan senjata
Greer: Waspada, tajam
Geo: Bumi
Grant: Besar, agung

Hudson: Anak dari Hugh
Hero: Pahlawan pemberani
Harley: Padang kelinci
Haven: Tempat perlindungan
Hawk: Elang, penglihatan tajam
Huxley: Hughâ€™s meadow
Hale: Sehat dan kuat
Hiro: Murah hati, dermawan
Holden: Lembah dalam
Hunter: Pemburu
Hayes: Dari pagar semak
Hendrix: Penguasa rumah
Harbor: Pelabuhan aman
Hart: Rusa jantan
Harris: Putra Harry
Halston: Kota batu suci
Highland: Dataran tinggi
Hadrian: Gelap
Holt: Hutan kecil
Hector: Memegang teguh
Horizon: Batas langit dan bumi
Hugo: Pikiran, jiwa
Heath: Tanah berumput
Hayden: Lembah berpagar

Indigo: Warna biru-ungu
Icarus: Terbang mendekati matahari
Ivory: Gading putih
Ilias: Yahweh adalah Tuhanku
Iron: Besi, simbol kekuatan
Ian: Tuhan itu murah hati
Irving: Air hijau
Idris: Pelajar, bijaksana
Isidore: Hadiah dari Isis
Indy: Independen, mandiri
Iver: Pemanah
Ira: Waspada
Ike: Dia akan tertawa
Ilyan: Sinar matahari
Isador: Hadiah Isis
Ignatius: Api
Inigo: Api yang membara
Idris: Pangeran atau pemimpin
Io: Bulan Jupiter
Irving: Teman yang hijau
Ibsen: Anak dari Ibb
Ingram: Anak dari Ing
Iver: Pemanah
Iridian: Pelangi

Jasper: Pembawa harta
Jericho: Kota bulan
Jett: Batu hitam mengilap
Julian: Muda, penuh energi
Journey: Perjalanan hidup
Jude: Yang dipuji
Jax: Tuhan telah memberi rahmat
Jupiter: Planet terbesar
Jade: Batu hijau berharga
Jarvis: Tombak yang terkenal
Jace: Penyembuh
Jorah: Hujan musim gugur
Jacques: Pengganti
Joaquin: Tuhan akan menilai
Jesper: Kekayaan
Justice: Keadilan
Jagger: Pedagang
Jorah: Hujan musim gugur pertama
Jovian: Seperti Jupiter
Jordy: Mengalir turun
Jaeger: Pemburu
Jethro: Kelebihan
Jalen: Tenang, damai
Jiro: Anak kedua

Kai: Laut
Koa: Pejuang
Knox: Bukit bulat
Kian: Kuno, jauh
Knight: Kesatria
Killian: Gereja kecil
Kylo: Langit
Keanu: Angin sejuk
Kenzo: Bijaksana ketiga
Kairos: Momen yang tepat
Kyros: Tuan atau penguasa
Kelvin: Teman dari sungai
Kael: Kuat dan maskulin
Kamden: Lembah berkelok
Kieran: Kecil dan gelap
Kingston: Kota raja
Khan: Penguasa
Keats: Gembala
Kendrick: Pemimpin berani
Kaleb: Setia
Kent: Tepi
Kade: Teman kecil
Kerr: Orang dari rawa-rawa
Kobi: Bintang

Levi: Bergabung, menyatu
Leo: Singa
Luna: Bulan
Lark: Burung kecil
Legend: Kisah terkenal
Linden: Pohon limau
Lucian: Cahaya
Lennox: Dengan banyak pohon elm
Lachlan: Dari tanah danau
Lazarus: Tuhan telah membantu
Lynx: Kucing liar
Leif: Pewaris yang dicintai
Lysander: Pembebas manusia
Lance: Tanah
Lowell: Anak serigala kecil
Landry: Penguasa tanah
Lir: Laut
Laurent: Dihiasi daun salam
Laszlo: Penguasa kemuliaan
Leander: Singa-manusia
Lincoln: Koloni di danau
Lux: Cahaya
Lionel: Singa muda
Larkin: Seniman kecil

Milo: Prajurit berbelas kasihan
Magnus: Besar, hebat
Mace: Senjata
Moon: Bulan
Maverick: Independen, tidak konvensional
Malachi: Utusan Tuhan
Mercury: Planet terdekat dengan matahari
Mars: Dewa perang
Moss: Tumbuhan hijau
Merlin: Burung elang laut
Maximus: Terbesar
Micah: Siapa seperti Tuhan?
Maze: Labirin
Monty: Gunung tajam
Marcel: Seperti Mars, pejuang
Milan: Penuh kasih sayang
Melville: Desa buruk
Morven: Puncak gunung besar
Marlow: Sisa danau
Maddox: Anak dari Madoc
Monroe: Mulut sungai
Maceo: Hadiah Tuhan
Myer: Pemberi cahaya
Midnight: Tengah malam

Nova: Bintang baru
Nile: Sungai yang panjang
Neo: Baru
Noir: Hitam
Nash: Di bawah abu
Nolan: Terkenal, mulia
Neptune: Dewa laut
North: Arah utara
Noel: Kelahiran
Navarro: Dataran
Nyx: Malam
Nio: Baru
Noble: Bangsawan
Niko: Kemenangan rakyat
Novak: Orang baru
Nephele: Awan
Nemo: Tidak seorang pun
Nestor: Pulang dengan selamat
Narcissus: Diri sendiri
Noctis: Malam
Newton: Kota baru
Neville: Kota baru
Nuri: Cahayaku
Nox: Malam

Orion: Pemburu di langit
Ocean: Lautan luas
Onyx: Batu hitam
Otto: Kaya, makmur
Odin: Pemimpin para dewa Norse
Osiris: Dewa kebangkitan Mesir
Oberon: Raja peri
Oliver: Pohon zaitun
Oakley: Padang pohon ek
Odysseus: Orang yang marah
Oleander: Bunga beracun yang indah
Orson: Anak beruang
Otis: Kekayaan
Oak: Pohon ek yang kuat
Omar: Pembicara yang fasih
Oswald: Kekuatan dewa
Owain: Lahir dari yew
Osric: Penguasa ilahi
Olympus: Gunung para dewa
Ovid: Domba
Orlan: Dari tanah emas
Oz: Kekuatan
Octavian: Kedelapan
Ozias: Kekuatan Tuhan

Phoenix: Burung yang bangkit dari abu
Perseus: Penghancur
Pax: Damai
Pike: Bukit runcing
Paxton: Kota damai
Peregrine: Penjelajah
Palmer: Peziarah
Paris: Dari Paris
Poet: Penyair
Pier: Batu
Prosper: Beruntung, sukses
Phineas: Mulut tembaga
Pollux: Mahkota
Pierce: Batu
Pascal: Lahir saat Paskah
Percival: Menembus lembah
Prism: Bentuk geometris
Poe: Penyair
Paladin: Kesatria
Pharaoh: Raja Mesir kuno
Powell: Kecil
Pillar: Tiang penyangga
Penn: Kandang
Pace: Damai

Quill: Pena bulu
Quincy: Estate kelima
Quest: Pencarian
Quartz: Kristal
Quinn: Bijaksana
Quantum: Jumlah terkecil
Quillan: Dari pohon crab
Quasar: Inti galaksi aktif
Quinlan: Sangat kuat
Quade: Keempat
Quirinus: Tombak
Quillon: Pedang atau mata pisau
Quimby: Wanita dari properti raja
Quinnell: Pohon oak kecil
Quenton: Tanah ratu
Quirin: Tombak
Quillen: Anak muda
Quinton: Kelima
Quebec: Penyempitan
Quigley: Dari rambut diikat
Qasim: Pembagi
Quentrell: Arus sungai
Qadir: Berkuasa
Qiang: Kuat


Rowan: Pohon berbunga merah
Rhett: Nasihat
Reign: Berkuasa
Rune: Misteri tertulis
River: Aliran air
Raven: Burung gagak hitam
Remy: Pendayung
Rex: Raja
Rafik: Teman, kawan
Roman: Warga Roma
Ryker: Kekayaan
Rogue: Penyendiri
Reed: Buluh, tebu
Rafferty: Kemakmuran
Rainier: Penasihat yang bijak
Rand: Perisai serigala
Rockwell: Mata air di batu
Rigel: Bintang terang
Renzo: Pemenang
Ronan: Segel kecil
Ridge: Punggung bukit
Royce: Putra raja
Raziel: Rahasia Tuhan
Ruslan: Singa

Silas: Hutan
Sage: Bijaksana
Sterling: Kualitas tinggi
Soren: Tegas
Sol: Matahari
Slate: Batu
Storm: Badai
Sullivan: Mata hitam
Sparrow: Burung pipit
Stellan: Tenang
Sayer: Pembicara
Scout: Penjelajah
Sierra: Pegunungan bergerigi
Sable: Hitam
Samson: Seperti matahari
Sinclair: Terkenal, cerah
Silver: Perak
Skyler: Cendekiawan
Stark: Kuat, tegas
Soren: Tegas
Solace: Penghiburan
Shepard: Gembala
Sylvan: Dari hutan
Saxon: Pedang pendek

Theo: Pemberian Tuhan
Tate: Ceria
Thorn: Duri
Thatcher: Pembuat atap jerami
Titan: Raksasa
Tristan: Sedih
Talon: Cakar burung pemangsa
Truth: Kebenaran
Thor: Dewa petir
Timber: Kayu bangunan
Tenzin: Pemegang ajaran
Tarik: Bintang pagi
Tesla: Dari Thessaly
Tiber: Sungai di Roma
Tavish: Kembar
Tyson: Anak dari perancang
Tempest: Badai
Thayer: Tentara
Troy: Kota legendaris
Tobin: Yang baik
Taurus: Banteng
Thaddeus: Berani
Travers: Penyeberangan
Tennison: Anak Dennis

Ulysses: Yang marah
Urban: Dari kota
Uriah: Tuhan adalah cahayaku
Upton: Dari kota atas
Uziel: Kekuatan Tuhan
Uri: Cahayaku
Umar: Hidup panjang
Unwin: Tidak bisa dikalahkan
Usher: Penjaga pintu
Ulrik: Penguasa warisan
Upton: Dari kota atas
Umber: Warna coklat kemerahan
Udo: Kekayaan
Union: Persatuan
Urien: Kelahiran istimewa
Urbain: Dari kota
Uzi: Kekuatanku
Utah: Puncak gunung
Uther: Mengerikan
Unity: Kesatuan
Utley: Luar, jauh
Ukiah: Lembah dalam
Universe: Alam semesta
Upendo: Cinta

Vale: Lembah
Valor: Keberanian
Vance: Tanah rawa
Victor: Pemenang
Vesper: Senja
Viggo: Perang
Valentine: Kuat, sehat
Varian: Beragam
Vega: Bintang terang
Vermillion: Merah terang
Venture: Petualangan
Valen: Kuat
Valiant: Pemberani
Void: Kekosongan
Voss: Rubah
Vaughn: Kecil
Valor: Keberanian
Vision: Pandangan
Vitus: Kehidupan
Vicon: Dari desa
Varden: Dari padang hijau
Vidar: Pejuang hutan
Valcen: Kuat
Voltaire: Cepat

Wilder: Tidak terkendali
Wolf: Serigala
Wren: Burung kecil
West: Arah barat
Walden: Lembah yang dilindungi
Weston: Dari kota barat
Wyatt: Pemberani dalam perang
Weaver: Penenun
Whit: Putih, cerah
Wilde: Liar, tidak terkendali
Wallace: Orang Wales
Wells: Mata air
Windsor: Tepi sungai berbelok
Whitman: Orang putih
Woodrow: Baris pepohonan
Winslow: Bukit teman
Wade: Menyeberangi
Warrick: Pelindung
Wilfred: Menginginkan kedamaian
Winston: Kota teman
Walton: Kota di hutan
Warwick: Desa bendungan
Wyclef: Dari tebing putih
Watson: Anak Walter

Xander: Pembela manusia
Xavier: Rumah baru
Xylon: Dari hutan
Xerxes: Penguasa para pahlawan
Xenos: Orang asing, tamu
Xabi: Ayah baru
Xero: Kering
Xenon: Gas mulia
Xian: Immortal
Xolani: Damai
Xiomar: Terkenal dalam pertempuran
Xanthus: Kekuningan
Xaviell: Rumah baru yang cerah
Xerius: Bijaksana
Xaden: Dari tanah X
Xanthian: Kuning keemasan
Xenophon: Suara asing
Xavion: Rumah baru yang agung
Xennon: Tamu atau pengunjung
Xeon: Bersinar
Xarius: Raja besar
Xylon: Dari kayu
Xavius: Rumah baru
Xzavier: Rumah baru yang cemerlang


Yosef: Dia akan menambah
Yale: Tanah tinggi subur
York: Dari pertanian yew
Yves: Kayu pohon
Yuri: Petani
Yasir: Kaya
Yeats: Penyair
Yorick: Petani
Yanni: Tuhan itu murah hati
Yarrow: Tanaman obat
Yael: Kekuatan Tuhan
Yates: Gerbang
Yancy: Inggris
Yarden: Mengalir ke bawah
Yash: Kemuliaan, ketenaran
Yardan: Dari taman
Ymir: Suara dari pohon
Yedidya: Teman Tuhan
Younis: Merpati
Yehudi: Pujian
Yaron: Akan bernyanyi
Youngblood: Darah muda
Yael: Rusa ibex
Yardley: Dari padang rumput yang terpagar

Zephyr: Angin barat
Zane: Hadiah Tuhan
Zion: Tempat tertinggi
Zen: Meditasi
Zayn: Keindahan
Zeus: Raja para dewa Yunani
Zuriel: Batu saya adalah Tuhan
Zayden: Jalan baru
Zev: Serigala
Zenith: Puncak tertinggi
Zander: Pembela umat manusia
Zephyrus: Dewa angin barat
Zaccai: Murni
Zakai: Tidak bersalah
Zenon: Hadiah Zeus
Zephyrin: Angin barat
Zorion: Kebahagiaan
Zamir: Nyanyian
Zavian: Cemerlang
Zaire: Sungai
Zahir: Yang bersinar
Zarek: Pelindung raja
Ziggy: Kemenangan
Zennor: Benteng di tepi laut.