Aksa: Orang yang selalu jernih air mukanya
Arion: Mempesona, memikat hati
Arshaka: bersyukur, orang yang murah hati
Arvin: Teman yang baik bagi semua orang
Aliando: Mulia dan bahagia
Alec: Pelindung umat manusia
Axelle:  Pembawa kedamaian
Azada: Kebebasan
Adhitama: Tampan dan indah
Azura: Biru langit
Abhimanyu: Anak dari Arjuna
Abayomi: Anak yang lahir membawa kebahagiaan
Azri: Cerdas
Alvaro: Bijaksana 
Arkana: Berhati terang
Arrayan: Pohon yang berbau harum
Andhra: Kuat dan berani
Aydin: Keteguhan dan kebijaksanaan
Abrisam: Tampan dan lembut
Achazia: Raja
Abinaya: Semangat
Abbas: Singa, pemimpin
Abizar: tambang emas, yang menyebarkan
Abqary: jenius, pintar, cerdas
Abraham: pembawa pesan dari Tuhan
Adnan: penenang hati
Afif: punya harga diri
Aidan: pohon palem yang tinggi
Alvan: agung
Alzam: tekun
Ameer: penguasa atau pemimpin
Amaar: menjadi makmur, pembangun
Aqila: Bijaksana, pandai
Asad: senang, berbahagia, beruntung, singa
Atlas: nama dewa Yunani yang menopang Bumi
Atalaric: harum
Atha: pemberian
Attar: murni, suci, bersih
Aulian: pemimpin, semangat, malaikat, teman
Azam: agung, terhebat, paling penting, rajin, tekun
Azhar: bercahaya, lebih cerah, yang berseri, yang gemilang
Aziz: yang mulia, yang kuat, kekasih
Aarush: matahari
Advik: unik
Austin: yang hebat
Ardashir: pemimpin yang jujur
Aryan: yang mulia, yang suci
Anzel: Tuhan maha pemurah
Arshakalif: orang yang bijaksana
Axel: ayah dari kedamaian

Bahr: laut, lautan
Bahran: bercahaya
Bahi: indah, yang sempurna
Bahy: yang tampan dan elok matanya
Baihaqi: imam perawi hadist
Baim: penguasa yang baik
Bais: tentara
Bakhtiar: yang bahagia
Banan: ujung jari
Bani: kaum
Banin: bijak, gigih
Baqir: pembelah, yang berilmu
Bariq: bercahaya, kemilau
Barra: keteguhan, berkah Tuhan, memiliki kekuasaan, bersih
Barraq: bersinar, berkilau, cemerlang
Bashir: pembawa berita baik
Basil: singa
Basman: yang banyak tersenyum
Behzad: jujur, perhatian
Bilal: terpilih
Bin: Seorang anak laki-laki
Bryan: Daratan tinggi
Bruno: Rambut kecoklatan
Brandon: Gunung yang tinggi
Bradley: Seorang yang pemberani
Bobby: Sebuah anugerah
Bishal: Kekuatan, yang memimpin
Benny: Yang dapat dipercaya
Bose: Yang menguasai, kecerdasan
Bentley: Tanaman yang lebat, ketenangan
Brock: Binatang pengerat, bisa bermakna anak yang kuat dan hebat

Caden: teman, kerabat
Caleb: dermawan
Carim: murah hati, dermawan
Casildo: pemuda pejuang
Cazim: penyabar
Cemal: keindahan
Chafik: bersimpati
Chaker: berterima kasih
Chanan: Tuhan itu Maha Pengasih
Chahid: saksi
Chairi: kebaikanku
Chairil: kebaikan
Chan: bersinar
Charagh: cahaya dalam gelap
Chashida: berpengalaman, terpelajar
Chawki: memberikan kenyamanan
Chinar: sebuah pohon
Chokri: diberkati
Chumaidi: pujaanku
Coman: mulia, luhur, bangsawan, ningrat
Calvin: Bersinar
Cedric: Alternatif
Cody: Kecerdasan
Charles: Kekuatan, pemimpin
Cyrus: Seperti matahari, bersinar
Cameron: Cerdas
Cal: Yang berharga
Carlton: Perkotaan
Chan: Cahaya
Charilie: Seorang yang diberkahi
Callum : merpati
Cruz: berkat, kebaikan

Damian: Sahabat yang baik.
Delvin: Teman yang baik.
Delana: Pelindung orang yang mulia
Devan: Puisi
Dylan: Anak laut
Daanii: dekat
Daarii: mengetahui
Daaris: pembaca, pelajar
Daffa: banyak memiliki pertahanan diri
Dahdy: yang tercinta
Daifullah: tamu Allah
Daim: kekal abadi
Dalil: penunjuk, alasan
Daiyan: hakim, pembalas
Danesh: kebijaksanaan, terpelajar
Daniyal: pintar, cerdas
Dary: pandai, bijaksana
Dawud: yang tercinta
Dayyan: penguasa yang agung dan kuat
Dhafi: tamu
Dhakiy: pintar, cemerlang
Dhia: sinar, cahaya, sinaran kebenaran
Dhiaulhaq: sinar cahaya
Durrani: permataku
Dzuhairi: baik, cerdas, beruntung
Darsh: Pemimpin
Diyan: Lampu
Dilan: Sebuah kebaikan
David: Yang dicintai
Dev: Yang dikagumi
Derek: Raja
Danny: Berlaku adil
Daniel: Yang berlaku adil
Darren: Bukit yang tinggi
Desmond: Laki-laki pintar
Dominic: milik Tuhan


Evano: Anugerah Tuhan yang paling indah
Ersya: Anak yang bersemangat dan cerdas
Ezra: Pertolongan
Ephraim: Selalu berhasil dengan baik
Elvano: Anak yang kuat hadiah dari Tuhan
Edzard: Penjaga kekayaan
Ebrahim: pembawa pesan dari Tuhan
Efendi: laki-laki lembut
Ehan: bulan purnama
Ehsan: kuat, baik
Eiham : fantasi
Eijaz : keajaiban atau berkat
Eisa : Tuhan penyelamat
Eiwa : pelindung
Einas : ketenangan
El Amin : dapat dipercaya
El Fatih : pemenang
Emery: penuh kasih
Emran : berkembang, sukses
Emir : Pangeran yang memesona
Esfand : murni, suci
Eshaal : penyelesaian
Eshan : dalam kasih Allah
Ettifaq : harmoni, kesatuan, persahabatan
Eyab : kembali
Ezaz : karunia dari Allah
Ezhar : bunga-bunga, yang berseri, yang gemilang, lebih cerah
Ethan : kuat


Faresta  : Malaikat
Fajrin     : Kebahagiaan, kekuatan, pengetahuah luas, dan jalan hidup yang tentram
Farrel     : Manusia pemberani
Farzan    : Bijaksana
Faadhil : berlimpah, mulia, beruntung dan memiliki banyak kebaikan
Fadgham : lelaki yang memesona
Faidhan : lelaki yang banyak kebajikannya
Faiq : baik, istimewa, unggul
Fakhri : kemegahanku, kebanggaan
Faisal : pemisah antara hak dan batil, tegas
Fannan : seniman
Faqih : ahli Fiqih, cerdas, pintar, sangat alim
Fariq : bisa membedakan yang baik dan yang tidak baik
Farras : cerdas, banyak akal, tajam pikirannya
Fathan: kemenangan, cerdas, bijaksana
Fatih : penakluk, pemimpin
Fattah : Penakluk
Fattan : yang memikat, menarik hati
Fauzan : kemenangan
Fawad : hati, jiwa
Fawwaz : yang selalu beruntung
Fidai : pengorbanan
Firas : gigih, kecerdikan
Firhan : yang bahagia, yang senang
Frey : mulia
Felix : bahagia dan makmur


Gandhi : Anak yang berilmu
Gunadhya : Kekayaan dalam kebaikan
Galaxy: gugus bintang, luar angkasa
Galen: tenang
Gavin : Elang putih
Gilang : Anak yang teguh
Gafar : suka memaafkan
Gaffi : berhati lembut
Ghaaziy : pejuang yang tidak kenal lelah
Ghadi : singa
Ghaffar : lembut hati, sedia mengampuni
Ghafif : pemaaf, sedia mengampuni
Ghaly : berharga, mahal
Ghanim : sukses, berhasil
Ghauts : bantuan, pertolongan, uluran.
Ghava : lembut hati
Ghazam : sayang, cinta
Ghazi : pejuang
Ghazwan : penakluk
Ghifari : pengampun, lembut hati
Ghiyats : bantuan yang tepat pada waktunya, hujan
Ghonim : keuntungan; kebahagiaan
Ghufran : ampunan
Ghyr : memiliki kecemburuan tinggi terhadap agama
Gibran : yang terpandai
Gifar : lembut
Griffin: dewa yang kuat

Haadii : yang memberi petunjuk, penunjuk jalan
Hadaya : pemberian, hadiah
Haddad : pandai besi, kuat kemauan
Hadziq : yang cerdik, pandai, mahir, cakap
Haedar : pemberani
Hafsya : yang berusaha sungguh-sungguh
Hafuza : pemberi semangat
Haikal : pokok yang besar dan subur
Haitham : berani
Hammam : memiliki ambisi yang kuat, bertekad kuat
Hammami : pemberi semangat
Hanai : kebahagiaan
Hanan : lemah lembut, penuh kasih sayang
Hariz : yang kokoh, yang kuat
Harraz : yang amat warak
Harzan : penjagaan
Hasanain : bagus, baik, dua kebaikan
Hasbi : mencukupi
Hasybi : pemberi, pembuat perhitungan
Husam : pedang yang tajam
Henley : padang di dataran tinggi
Horace: pekerja keras dan ramah
Hoshi: Bintang, cahaya bintang
Harrison: Anak yang berbakti
Hamza: Singa
Harvey: Posisi yang tinggi

Ibad : yang rajin beribadah
Ikbal : kejayaan, penerimaan
Ikhlash : tulus hati, rela
Ikhtiari : pilihanku
Ikram : menghormati
Ilmi : ilmu
Imran : budi bahasa
Insan : manusia
Irsyad : petunjuk
Ishlah : perdamaian
Isham : baik hati, penuh perhitungan
Istiqlal : merdeka, bebas
Isyraf : perhatian, pengawasan
Isyraq : menginspirasi, kuat
Ithar : mengasihi orang lain
Izaz: kehormatan, harga diri, kasih sayang.
Izz: kekuatan
Izzat: kemuliaan
Izdihar: perkembangan, kemajuan
Izdiyad: pertambahan
Irish : dewa bumi dalam kepercayaan Hindu
Ihsan: Matahari
Ivan: Hadiah dari Tuhan
Inshal: Pemberani
Ilias: Pemberi
Irvin: Air yang mengalir
Iann: Selalu memberi, dermawan
Indranil: Kebiruan
Irshaad: Yang mendampingi
Irwan: Kemurnian
Ibsham: Pohon yang tinggi
Ibrahim: Bapak dari banyak orang, pemimpin
Ilham: Inspirasi, petunjuk
Ishaq: Tertawa, gembira
Irfan: Pengetahuan, kebijaksanaan
Ismail: Didengar oleh Tuhan
Ihsan: Kebaikan, kesempurnaan
Imran: Makmur, sejahtera
Idris: Rajin belajar, tekun
Ikhsan: Kemurahan hati, kebaikan
Izzan: Kepatuhan, ketaatan
Iqbal: Kemakmuran, keberuntungan
Islah: Perbaikan, reformasi
Irsyad: Bimbingan, petunjuk
Inara: Bersinar, terang
Izam: Keagungan, kemuliaan



Jaasir: pemberani, mencerminkan kesuburan dan keberuntungan
Jabil: yang kreatif
Jabr: yang menghimpun, orang yang senang berorganisasi untuk memerangi perpecahan.
Jad: sungguh-sungguh, dermawan
Jafin: yang mengawal
Jafni: kawalanku dari kejahatan
Jaiz: boleh
Jauhar: batu mulia, permata
Jax: Tuhan telah bermurah hati
Jazim: sebuah nama dari bunga melati bentuk yang lebih tua
Jazlan: gembira, riang
Jazli: fasih
Jazman: tekad bulat
Jazmi: tekad yang kukuh
Jefrey: tanah perdamaian
Jiyaad: yang terbaik
Juani: sinaranku
Juhair: suara yang nyaring/merdu, lantang
Juhara: batu mulia
Juhlan: yang termulia
Joe: Pemberani
Jimmy: Yang dikenang
Jordan: Mengalir
Julian: Lahir di bulan Juli
Jay: Kemenangan
Jareth: Seimbang
James: Orang ramah
Johnson: Seorang anak
John: Kecerdasan
Jovan: Seorang laki-laki
Justin: Kebenaran, pemikiran yang benar
Jabbar: Perkasa, kuat
Jafar: Sungai kecil, aliran
Jamal: Tampan, rupawan
Jibrail: Kekuatan Tuhan

Kenzo : Kreatif dan pintar
Kalandra : Anak periang yang membawa keceriaan dalam masyarakat
Kenan : Tegas, tajam, tekun, dan rela berkorban
Keanu : Hembusan sejuk dari atas gunung
Kenzie : Pemimpin yang bijaksana dan dapat memberi keadilan
Kaaf : kesenangan, bersemangat
Kaamil : memiliki sifat-sifat sempurna
Kafi : sempurna, lengkap
Kafil : yang menanggung atau menjamin
Kaif : kesenangan; bersemangat
Kairi : kebaikan
Karim : mulia, dermawan
Kashif : pembuka, penemu
Kazi : hakim
Kazim : penyabar
Khafi : yang tersembunyi
Khair : terbaik
Khaisan : yang bijak
Kanav : kisah lawas yang bijak
Kai: Seorang pemimpin
Kaivan: Anak laki-laki yang tampan
Ken: Tangguh
Keenan: Sebuah keyakinan
Kellandra: Penuh pesona
Kyro: Seorang pemimpin

Latif: baik hati, lembut
Labib: pandai, cerdik, berakal
Labid: singa, pemberani
Lateef: menyenangkan
Lathif: lemah lembut
Lamya: berkilau; memancar
Lateef: menyenangkan
Layyin: lembut, halus
Lihaf: yang menghangatkan kain, selimut
Lujain: perak
Luqman: yang cerdas, jalan terang
Luthfi: kelembutanku
Laaiq: cocok, memenuhi syarat, berkualitas
Labis: pelindung
Lahiq: pengikut, meraih, seseorang yang mengikuti dan meraihnya (cita-cita)
Lutfan: kelembutan, kebaikan
Luham: hebat
Liam: pelindung yang tegas
Lainufar: pokok teratai
Lahin: cerdik, pandai
Luca: pembawa cahaya

Mahardika: Berbudi luhur
Mahendra: Raja yang sabar dalam bahasa arab.
Mahawira: Pahlawan yang besar
Maharth: jujur
Melviano: Pemimpin yang terhormat 
Mahaprana: Anak yang penuh sikap optimis
Mirza: Anak yang baik
Milo: pejuang yang penuh pengampunan
Madava: Muda, segar
Matteo: Pemberian dari Tuhan
Mukesh: Teman setia
Maaz: Laki-laki pemberani
Moiz: Yang memberikan perlindungan
Mahir: Pandai
Mehdi: Jalan yang benar
Mehram: Teman dekat
Moni: Kesunyian
Manik: Berlian
Monty: Kreativitas
Mahbub: Orang yang disayang
Mason: Pekerja keras
Misam: Seorang yang perhatian
Mayukh: Matahari
Monish: Seorang pemilik
Malek: Pemimpin
Max: yang agung


Naafi: yang memberi manfaat
Naashir: suka menolong
Naayif: tinggi
Nabhan: mulia, terkenal, perwira
Nabigh: orang yang unggul
Nachar: banyak menolong
Nadhif: bersih
Nadhirrizky: mendapatkan rezeki yang baik
Nadiim: pendamping
Nadil: perjuangan
Nadiy: pemurah
Nafi: berguna
Nafis: berharga, bernilai
Naim: kebaikan, kenyamanan, ketenangan
Nasrul: kemenangan dari Allah
Naufal : baik hati, dermawan dan tampan
Naushad : bahagia
Nawfal : murah hati
Nazhief : bersih
Negm : bintang
Noah: damai


Oba: raja
Obaid: hamba
Ocean: lautan
Osama: singa
Ollie: berani
Osmond: perlindungan, perkasa
Orian: keberuntungan
Oricon: indah
Ogaima: pemimpin
Oliver: pasukan peri
Omair: cerdas
Oman: pelindung tinggi, anak pertama laki-laki
Omran: umur panjang
Omri: umur panjang
Onn: pertolongan, bantuan
Oringo: anak laki-laki
Orlen: matahari bersinar
Oscar: cerdik, bijaksana, cerdas
Osman: pelayan Allah
Oswald: kekuatan yang suci, baik hati, tegas, berpendirian mantap
Othman: yang tekun
Otis: kaya raya
Owen: seseorang yang beruntung
Ozak: yang menyediakan

Pax: damai
Pradipa: Terang bercahaya
Pranadipa:  Makna dalam kehidupan
Prambudi: Sejati, pandai, setia
Parviz: Anak yang beruntung, mujur.
Pahlevi: baik, berani, taat beragama, dermawan
Parvez: sukses
Pervaiz: hembusan
Pasha: tuan, yang mulia
Pasya: raja, pemimpin
Pritam: Yang dikasihi dan dicintai
Priyam: Kasih sayang
Parsa: Seorang pelindung
Pawan: Udara, angin segar
Patrick: Yang mendapat penghargaan
Prayan: Kecerdasan luar biasa
Padman: Bunga lotus
Prince: Pangeran
Preston: Bangunan kokoh
Pete: Keadilan
Param: Sebuah angin
Pulkit: Kebahagiaan
Parker: Bijaksana
Pradipta: Cahaya
Pram: Sebuah cinta dan afeksi
Pratham: Yang pertama


Qabil : yang menjaminkan, yang menanggung
Qafil : yang kembali dari perjalanan
Qaifun : yang mengetahui ilmu filsafat
Qais : perbandingan, kekuatan
Qari : lelaki pembaca Alquran
Qashid : yang menuju pada kemudahan
Qasam : sumpah
Qasar : meringkas
Qasbah : menuntut ilmu
Qasid : penyampai pesan
Qasif : penemu
Qasim : pembagi, yang lurus, rupawan
Qawi : gagah, perkasa
Qazun : sutera
Qindil : pelita
Qiyas : tegas
Qiwam : dukungan, sokongan, penolong
Qushai : berpikir jauh ke depan
Qolbu : hati, sesuatu yang halus
Qutb : pemimpin
Quill: penolong
Quilon: cerdas
Qahi: kemenangan
Qane: penyabar
Quinn: cerdas

Rezvan: Anak yang suka ilmu pengetahuan
Raka: Anak yang teguh, bijaksana, memiliki pengaruh dan kekuasaan
Rafardhan : Anak laki-laki yang bercahaya cemerlang
Raefal: Kebahagiaan dan kehormatan
Reinaldo: Pemimpin yang bijaksana
Radhitya: Matahari
Reifansyah: Kebaikan yang menghasilkan
Rayshiva: Pelindung yang beruntung
Radhika: Sukses dan makmur
Rasendriya : Memiliki ketajaman pancaindera
Raihan: Tumbuhan yang berbau harum
Rafisqy: Kesempurnaan dan kebaikan
Randi: Pelindung keluarga
Ravindra: Kekuatan matahari
Rauf: Penuh kasih sayang, lemah lembut
Rayyan : Cerdas, berwawasan luas
Rifqi : Kawan, pendamping
Ryan: Raja
Ryder: Ksatria
Reigha: Berkat
Roman: Kuat dan berkuasa
Rafi: Teman tinggi, terhormat
Rayhan: Harum, wangi
Rizki: Rezeki, berkah
Raziq: Pemberi rezeki
Raditya: Matahari, bersinar
Reyhan: Wangi, harum
Rakha: Pembawa kebahagiaan
Raka: Raja, pemimpin
Rasyad: Bijaksana, penunjuk jalan
Reza: Kepuasan, persetujuan
Rama: Menyenangkan, menarik
Rajendra: Raja para dewa
Raihan: Surgawi, pengasih
Rifqi: Teman, pendamping
Rashid: Penunjuk jalan yang benar

Salvador: Penyelamat
Syahreza: Laki-laki yang penuh kasih sayang
Sayudha: Penyembuh
Shaquille: Tampan
Saad : Bahagia
Sabil : Jalan
Sabqi : Keutamaan
Sadiq: Teman sejati
Safiq : Belas kasih
Safiy : Yang bersih dan jujur
Saghir : Yang mengikut
Sahnon : Kehalusan
Shabur : Penyabar
Sahlan : Mudah, senang
Sa’id : gembira, senang
Sa’iy : yang berjalan cepat
Sakha : kemurahan hati
Sami: pendengar yang baik
Sarhan : kemudahan
Saskara : kebenaran dan kemurnian
Shafi : jernih
Shaghir : kecil, muda
Shahib : kawan, teman sejawat
Shaib : yang benar
Silas: kayu
Syafid : penyayang
Sandy: Bepasir, yang pintar
Simon: Tuhan maha mendengar


Taamir : banyak kebaikan, banyak rezeki
Tabish : berkilau
Tabriz : pengungkapan suatu kebaikan
Taheem : murni
Tahir : yang bersih dan murni
Tahoor: kemurnian
Taiq : yang merindu
Talib : penuntut
Tamam : kesempurnaan
Tameez : bijaksana
Tanvir : cahaya
Taqa : yang bertakwa
Taqi : bertakwa
Taslim : penyerahan, kepatuhan
Taufiq : petunjuk, pertolongan
Tariq : penakluk
Thalib : pelajar, yang menuntut
Thilal : embun, hujan rintik-rintik
Thierry: penguasa yang kuat
Tabrani: nama Ulama
Taksa: sayap
Theo: anugerah Tuhan
Taavi: sangat disayangi
Tsani : yang kedua
Troy : prajurit


Uba : kaya raya
Ubbad : banyak ibadah
Ubaid : orang-orang yang beriman
Ubayd : penyembah
Uday : naik
Ujala : cerah
Ukail : pintar, pandai
Ulwan : tinggi
Ulhaq : kebenaran
Ulu : yang Empunya, punya
Unais : cinta, kasih sayang
Unays : yang lebih kecil
Uqaab : burung elang
Urfan : kebaikan
Uthman : rajin dan gigih
Utaibah : persimpangan lembah
Uwais : pemberian
Uwamir : pemberani, singa
Uzayr : berharga
Uzzam : singa
Ukkasya: orang pertama yang meminta doa dari rasulullah agar bisa masuk surga tanpa hisab

Va : kesetiaan, loyalitas
Valdi : kekuatan besar
Valeeqa : terpercaya
Vicky : tujuan, akal
Virendra : laki-laki yang mulia dan pemberani
Vihaan: Subuh
Vansh: Seorang yang pengertian
Vernon: Orang yang pandai dan bijaksana
Virat: Kekuatan
Vijay: Kemenangan
Ved: Ilmu pengetahuan yang penting
Veer: Seorang yang berani
Vincent: Ramah
Vimal: Seorang teman
Valentino: Orang yang sehat
Vardhan: Berkah
Videsh: Asing, orang ramah
Vanu: Teman
Vicktor: Kemenangan
Vijendra: Kemenangan
Verdian: Sebuah bukti

Wafa: menepati janji, merpati
Wafi: sempurna
Wafiq: sukses
Wafiy : setia, jujur
Wafri : kekayaanku, keluasanku
Wahnan : mudah, senang
Waiz : penasihat
Wajdi : bersemangat, penuh cinta, gembira
Walif : berteman
Waldan: anak baik
Waqar : ketenangan dan sopan santun
Washil : penghubung, yang menyatukan
Watsiq : kuat, kokoh, dapat dipercaya
Wajif : yang tekun, gigih
Wazni : yang menimbang secara adil
Wi’am : keakraban, kemesraan
Widad : kasih sayang, cinta, cita-cita
Wijdan : sanubari, hati
Wisam : penghargaan, bintang kehormatan, petanda
Wistara : tegas dan pandai
Witha : tampan, rupawan
Wyman: prajurit

Xabier : bersinar
Xabiya : angin timur
Xalvador: penyelamat
Xaquil : rupawan
Xavi: rumah baru
Xaver : bersinar
Xavier : bersinar, hebat, cerah
Ximraan: selebrasi, perayaan
Xyan: sinar matahari
Xylon: Kayu
Xana: Seorang pemimpin
Xander: Cahaya gemerlap
Xowie: kehidupan
Xabier: Rumah baru
Xavier: Cemerlang, terang
Xander: Pembela manusia
Xerxes: Penguasa pahlawan
Xavi: Cemerlang, bersinar
Xeno: Tamu, orang asing
Xian: Damai, kemuliaan
Xion: Surga, langit
Xico: Pembawa kedamaian
Xylon: Dari hutan
Xolani: Pembawa kedamaian
Xiomar: Terkenal dalam pertempuran
Xael: Kekuatan Tuhan
Xanthus: Keemasan, bersinar
Xenon: Unik, elemen langka

Yaala : kemuliaan, tinggi
Yabil : bijaksana, pemberi ampun
Yafi : dewasa
Yafiq : mulia, dihormati
Yahya : kebahagiaan, kehidupan
Yarif : orang yang berilmu
Yassar : kekayaan, kemewahan
Yasser : makmur
Yaslam : yang selamat, berserah
Yaslan : bijaksana
Yassar : serba mudah
Yeseren : kemudahan
Yeeshai: pemberani
Yusri: kesenangan
Yolan: berani
Yadin: petapa
Yola : kemuliaan
Yosrey : makmur
Yudanta : kuat dalam peperangan
Yuri: bunga lili
Yushar: banyak kemudahan
Yusni : anak laki-laki
Yusran : mudah
Yazdan : belas kasihan
Yazid : bertambah, berlebih
Yoshi: Keberuntungan
Yafi: Dewasa, bijaksana
Yahya: Hidup, pemberian Tuhan
Yusuf: Bertambah, berkembang
Yudha: Pejuang, ksatria
Yafiz: Sukses, berhasil
Yuvan: Pemuda, yang muda
Yudhit: Cerdas, bijak
Yasha: Hadiah Tuhan
Yehuda: Terpuji, disyukuri
Yohan: Rahmat Tuhan
Yardan: Mengalir ke bawah
Yuri: Petani, pekerja keras
Yuvan: Pemuda yang bersemangat
Yunus: Merpati, damai
Yaffa: Indah, menawan

Zayyan : Tampan, baik
Zaidan   :  Pekerjaan yang sempurna
Zidan      : Pengampunan dan kemerdekaan
Zachery  : Cerdas, berjiwa petualang, optimis, jujur
Zaahiy : wajah yang rupawan
Zaalan : rajin, giat
Zabda : pemberian
Zabran : kuat, mampu
Zafar : kemenangan, kejayaan
Zafran : kejayaan
Zahir : cahaya yang bersih
Zaki: cerdik, harum dan suci
Zaid : meningkat, bertumbuh
Zain: perhiasan
Zander: pembela manusia
Zane: Tuhan maha pengasih, kesayangan
Zavier : bersinar
Zayan : cemerlang
Zayid : dermawan, murah hati
Zidan: kemerdekaan
Zeeshan : tinggi
Zefa : kebaikan
Zhafir : menang, unggul
Zhafran : orang yang menang
Zhariif : cerdik
Zhian : kuat, bersemangat, bertenaga
Zufar : singa, pemberani
Zuhair : yang berseri
Zuhayr : pandai, istimewa